Season ID,date,Team,P,Home wins,Away wins,W,D,L,GF,GA,DIFF,PTS
2797068,25/01/24,Chelsea,30,9,6,15,7,8,50,27,23,52
2797068,25/01/24,Liverpool,30,8,7,15,11,4,49,29,20,56
2797068,25/01/24,Tottenham,30,9,4,13,10,7,44,32,12,49
2797068,25/01/24,Manchester Blue,30,6,10,16,6,8,47,31,16,54
2797068,25/01/24,Bournemouth,30,9,6,15,8,7,45,32,13,53
2797068,25/01/24,West Ham,30,3,2,5,9,16,27,47,-20,24
2797068,25/01/24,Manchester Reds,30,8,2,10,9,11,43,36,7,39
2797068,25/01/24,Wolverhampton,30,4,5,9,7,14,29,40,-11,34
2797068,25/01/24,Watford,30,4,3,7,11,12,34,45,-11,32
2797068,25/01/24,London Guns,30,11,7,18,6,6,51,28,23,60
2797068,25/01/24,Everton,30,5,5,10,7,13,43,46,-3,37
2797068,25/01/24,Burnley,30,3,6,9,9,12,22,38,-16,36
2797068,25/01/24,Southampton,30,5,4,9,7,14,36,52,-16,34
2797068,25/01/24,Leicester,30,4,5,9,10,11,42,47,-5,37
2797068,25/01/24,Crystal Palace,30,3,4,7,11,12,30,42,-12,32
2797068,25/01/24,Newcastle,30,3,3,6,6,18,21,41,-20,24
2797095,25/01/24,Chelsea,30,11,6,17,8,5,52,28,24,59
2797095,25/01/24,Liverpool,30,8,8,16,9,5,51,28,23,57
2797095,25/01/24,Tottenham,30,7,0,7,8,15,36,49,-13,29
2797095,25/01/24,Manchester Blue,30,10,8,18,6,6,57,32,25,60
2797095,25/01/24,Bournemouth,30,6,5,11,12,7,30,25,5,45
2797095,25/01/24,West Ham,30,4,5,9,7,14,27,41,-14,34
2797095,25/01/24,Manchester Reds,30,10,8,18,8,4,50,25,25,62
2797095,25/01/24,Wolverhampton,30,5,2,7,11,12,24,41,-17,32
2797095,25/01/24,Watford,30,6,3,9,11,10,34,36,-2,38
2797095,25/01/24,London Guns,30,10,5,15,8,7,48,30,18,53
2797095,25/01/24,Everton,30,6,4,10,9,11,42,48,-6,39
2797095,25/01/24,Burnley,30,5,4,9,10,11,31,31,0,37
2797095,25/01/24,Southampton,30,3,1,4,6,20,22,51,-29,18
2797095,25/01/24,Leicester,30,7,4,11,7,12,41,36,5,40
2797095,25/01/24,Crystal Palace,30,3,2,5,7,18,23,50,-27,22
2797095,25/01/24,Newcastle,30,3,4,7,7,16,28,45,-17,28
2797121,25/01/24,Chelsea,30,11,10,21,3,6,48,19,29,66
2797121,25/01/24,Liverpool,30,9,6,15,6,9,37,23,14,51
2797121,25/01/24,Tottenham,30,9,5,14,6,10,49,39,10,48
2797121,25/01/24,Manchester Blue,30,10,5,15,6,9,48,34,14,51
2797121,25/01/24,Bournemouth,30,7,6,13,10,7,40,28,12,49
2797121,25/01/24,West Ham,30,7,5,12,7,11,34,35,-1,43
2797121,25/01/24,Manchester Reds,30,6,6,12,9,9,45,31,14,45
2797121,25/01/24,Wolverhampton,30,8,7,15,4,11,29,30,-1,49
2797121,25/01/24,Watford,30,3,3,6,12,12,25,37,-12,30
2797121,25/01/24,London Guns,30,8,9,17,7,6,51,27,24,58
2797121,25/01/24,Everton,30,10,5,15,4,11,46,36,10,49
2797121,25/01/24,Burnley,30,4,4,8,5,17,27,47,-20,29
2797121,25/01/24,Southampton,30,3,0,3,6,21,17,56,-39,15
2797121,25/01/24,Leicester,30,7,3,10,5,15,33,39,-6,35
2797121,25/01/24,Crystal Palace,30,7,1,8,5,17,32,59,-27,29
2797121,25/01/24,Newcastle,30,2,3,5,7,18,22,43,-21,22
2797146,25/01/24,Chelsea,30,9,6,15,6,9,36,27,9,51
2797146,25/01/24,Liverpool,30,9,6,15,9,6,40,19,21,54
2797146,25/01/24,Tottenham,30,10,5,15,5,10,46,34,12,50
2797146,25/01/24,Manchester Blue,30,13,6,19,6,5,62,19,43,63
2797146,25/01/24,Bournemouth,30,9,4,13,8,9,35,31,4,47
2797146,25/01/24,West Ham,30,3,5,8,6,16,35,53,-18,30
2797146,25/01/24,Manchester Reds,30,8,4,12,5,13,47,40,7,41
2797146,25/01/24,Wolverhampton,30,9,4,13,6,11,31,27,4,45
2797146,25/01/24,Watford,30,6,4,10,7,13,30,37,-7,37
2797146,25/01/24,London Guns,30,7,9,16,6,8,46,31,15,54
2797146,25/01/24,Everton,30,4,7,11,7,12,36,42,-6,40
2797146,25/01/24,Burnley,30,5,5,10,7,13,26,35,-9,37
2797146,25/01/24,Southampton,30,8,1,9,5,16,21,36,-15,32
2797146,25/01/24,Leicester,30,6,2,8,10,12,34,46,-12,34
2797146,25/01/24,Crystal Palace,30,4,2,6,5,19,19,48,-29,23
2797146,25/01/24,Newcastle,30,4,3,7,8,15,25,44,-19,29
2797172,25/01/24,Chelsea,30,8,7,15,10,5,49,27,22,55
2797172,25/01/24,Liverpool,30,6,5,11,14,5,48,35,13,47
2797172,25/01/24,Tottenham,30,8,5,13,6,11,41,35,6,45
2797172,25/01/24,Manchester Blue,30,7,8,15,8,7,57,28,29,53
2797172,25/01/24,Bournemouth,30,5,4,9,9,12,35,42,-7,36
2797172,25/01/24,West Ham,30,2,6,8,10,12,31,39,-8,34
2797172,25/01/24,Manchester Reds,30,7,6,13,7,10,36,32,4,46
2797172,25/01/24,Wolverhampton,30,5,5,10,12,8,34,26,8,42
2797172,25/01/24,Watford,30,3,6,9,7,14,34,45,-11,34
2797172,25/01/24,London Guns,30,9,11,20,5,5,64,35,29,65
2797172,25/01/24,Everton,30,7,3,10,6,14,32,42,-10,36
2797172,25/01/24,Burnley,30,5,3,8,7,15,24,39,-15,31
2797172,25/01/24,Southampton,30,5,4,9,8,13,33,44,-11,35
2797172,25/01/24,Leicester,30,8,7,15,4,11,44,44,0,49
2797172,25/01/24,Crystal Palace,30,2,0,2,11,17,19,50,-31,17
2797172,25/01/24,Newcastle,30,3,5,8,6,16,26,44,-18,30
2797196,25/01/24,Chelsea,30,10,5,15,7,8,40,23,17,52
2797196,25/01/24,Liverpool,30,5,4,9,11,10,32,33,-1,38
2797196,25/01/24,Tottenham,30,9,8,17,6,7,54,31,23,57
2797196,25/01/24,Manchester Blue,30,10,10,20,7,3,70,27,43,67
2797196,25/01/24,Bournemouth,30,5,4,9,10,11,33,36,-3,37
2797196,25/01/24,West Ham,30,7,4,11,7,12,40,46,-6,40
2797196,25/01/24,Manchester Reds,30,8,4,12,10,8,37,31,6,46
2797196,25/01/24,Wolverhampton,30,7,5,12,9,9,26,29,-3,45
2797196,25/01/24,Watford,30,7,4,11,8,11,30,35,-5,41
2797196,25/01/24,London Guns,30,9,6,15,7,8,44,27,17,52
2797196,25/01/24,Everton,30,4,3,7,7,16,30,51,-21,28
2797196,25/01/24,Burnley,30,4,2,6,11,13,22,36,-14,29
2797196,25/01/24,Southampton,30,7,4,11,7,12,32,41,-9,40
2797196,25/01/24,Leicester,30,6,5,11,7,12,45,43,2,40
2797196,25/01/24,Crystal Palace,30,5,3,8,5,17,30,52,-22,29
2797196,25/01/24,Newcastle,30,5,0,5,3,22,21,45,-24,18
2797221,25/01/24,Chelsea,30,7,4,11,6,13,34,35,-1,39
2797221,25/01/24,Liverpool,30,12,9,21,4,5,67,28,39,67
2797221,25/01/24,Tottenham,30,9,5,14,6,10,57,44,13,48
2797221,25/01/24,Manchester Blue,30,10,10,20,6,4,57,21,36,66
2797221,25/01/24,Bournemouth,30,8,4,12,9,9,34,25,9,45
2797221,25/01/24,West Ham,30,3,2,5,6,19,24,48,-24,21
2797221,25/01/24,Manchester Reds,30,8,7,15,4,11,41,31,10,49
2797221,25/01/24,Wolverhampton,30,7,6,13,6,11,33,33,0,45
2797221,25/01/24,Watford,30,9,2,11,8,11,31,37,-6,41
2797221,25/01/24,London Guns,30,9,6,15,5,10,40,37,3,50
2797221,25/01/24,Everton,30,4,5,9,9,12,43,49,-6,36
2797221,25/01/24,Burnley,30,5,5,10,8,12,31,37,-6,38
2797221,25/01/24,Southampton,30,6,4,10,8,12,30,37,-7,38
2797221,25/01/24,Leicester,30,4,3,7,7,16,41,57,-16,28
2797221,25/01/24,Crystal Palace,30,5,3,8,8,14,36,57,-21,32
2797221,25/01/24,Newcastle,30,3,3,6,6,18,24,47,-23,24
2797248,25/01/24,Chelsea,30,8,7,15,7,8,45,27,18,52
2797248,25/01/24,Liverpool,30,7,6,13,9,8,43,33,10,48
2797248,25/01/24,Tottenham,30,10,4,14,5,11,54,44,10,47
2797248,25/01/24,Manchester Blue,30,9,4,13,5,12,50,41,9,44
2797248,25/01/24,Bournemouth,30,8,6,14,7,9,40,28,12,49
2797248,25/01/24,West Ham,30,7,4,11,3,16,30,40,-10,36
2797248,25/01/24,Manchester Reds,30,9,4,13,10,7,47,33,14,49
2797248,25/01/24,Wolverhampton,30,4,4,8,12,10,30,36,-6,36
2797248,25/01/24,Watford,30,9,4,13,10,7,39,28,11,49
2797248,25/01/24,London Guns,30,12,7,19,4,7,62,34,28,61
2797248,25/01/24,Everton,30,5,1,6,6,18,27,55,-28,24
2797248,25/01/24,Burnley,30,5,1,6,8,16,24,41,-17,26
2797248,25/01/24,Southampton,30,4,4,8,8,14,25,35,-10,32
2797248,25/01/24,Leicester,30,6,2,8,9,13,39,50,-11,33
2797248,25/01/24,Crystal Palace,30,10,3,13,7,10,41,39,2,46
2797248,25/01/24,Newcastle,30,7,2,9,4,17,25,57,-32,31
2797275,25/01/24,Chelsea,30,8,6,14,10,6,55,36,19,52
2797275,25/01/24,Liverpool,30,10,4,14,9,7,38,30,8,51
2797275,25/01/24,Tottenham,30,6,7,13,10,7,47,31,16,49
2797275,25/01/24,Manchester Blue,30,10,8,18,6,6,53,24,29,60
2797275,25/01/24,Bournemouth,30,8,4,12,13,5,47,33,14,49
2797275,25/01/24,West Ham,30,6,3,9,9,12,31,40,-9,36
2797275,25/01/24,Manchester Reds,30,7,7,14,8,8,41,32,9,50
2797275,25/01/24,Wolverhampton,30,6,3,9,11,10,25,28,-3,38
2797275,25/01/24,Watford,30,4,4,8,8,14,35,47,-12,32
2797275,25/01/24,London Guns,30,8,8,16,8,6,53,30,23,56
2797275,25/01/24,Everton,30,4,5,9,10,11,43,43,0,37
2797275,25/01/24,Burnley,30,3,4,7,9,14,28,39,-11,30
2797275,25/01/24,Southampton,30,5,2,7,4,19,20,44,-24,25
2797275,25/01/24,Leicester,30,4,3,7,6,17,30,44,-14,27
2797275,25/01/24,Crystal Palace,30,5,2,7,4,19,25,56,-31,25
2797275,25/01/24,Newcastle,30,6,4,10,7,13,40,54,-14,37
2797297,25/01/24,Chelsea,30,6,6,12,6,12,42,40,2,42
2797297,25/01/24,Liverpool,30,10,7,17,9,4,44,24,20,60
2797297,25/01/24,Tottenham,30,9,7,16,9,5,53,27,26,57
2797297,25/01/24,Manchester Blue,30,11,9,20,2,8,50,22,28,62
2797297,25/01/24,Bournemouth,30,7,3,10,9,11,42,35,7,39
2797297,25/01/24,West Ham,30,8,7,15,2,13,40,36,4,47
2797297,25/01/24,Manchester Reds,30,8,4,12,11,7,39,38,1,47
2797297,25/01/24,Wolverhampton,30,7,6,13,5,12,27,26,1,44
2797297,25/01/24,Watford,30,5,2,7,6,17,23,42,-19,27
2797297,25/01/24,London Guns,30,8,6,14,8,8,54,40,14,50
2797297,25/01/24,Everton,30,3,8,11,8,11,40,43,-3,41
2797297,25/01/24,Burnley,30,6,1,7,7,16,22,44,-22,28
2797297,25/01/24,Southampton,30,2,4,6,9,15,22,36,-14,27
2797297,25/01/24,Leicester,30,5,3,8,9,13,41,43,-2,33
2797297,25/01/24,Crystal Palace,30,4,4,8,8,14,27,45,-18,32
2797297,25/01/24,Newcastle,30,4,3,7,6,17,18,43,-25,27
2797325,25/01/24,Chelsea,30,8,8,16,7,7,44,23,21,55
2797325,25/01/24,Liverpool,30,7,9,16,7,7,43,24,19,55
2797325,25/01/24,Tottenham,30,6,7,13,10,7,48,31,17,49
2797325,25/01/24,Manchester Blue,30,9,6,15,8,7,62,32,30,53
2797325,25/01/24,Bournemouth,30,6,5,11,11,8,32,32,0,44
2797325,25/01/24,West Ham,30,3,2,5,5,20,27,63,-36,20
2797325,25/01/24,Manchester Reds,30,6,6,12,9,9,40,34,6,45
2797325,25/01/24,Wolverhampton,30,6,8,14,9,7,36,24,12,51
2797325,25/01/24,Watford,30,3,3,6,15,9,29,34,-5,33
2797325,25/01/24,London Guns,30,7,8,15,6,9,47,35,12,51
2797325,25/01/24,Everton,30,9,3,12,9,9,50,39,11,45
2797325,25/01/24,Burnley,30,5,6,11,9,10,26,29,-3,42
2797325,25/01/24,Southampton,30,4,2,6,1,23,22,51,-29,19
2797325,25/01/24,Leicester,30,2,5,7,9,14,33,58,-25,30
2797325,25/01/24,Crystal Palace,30,6,2,8,9,13,32,40,-8,33
2797325,25/01/24,Newcastle,30,4,3,7,8,15,25,47,-22,29
2797351,25/01/24,Chelsea,30,10,9,19,4,7,52,30,22,61
2797351,25/01/24,Liverpool,30,12,6,18,7,5,51,29,22,61
2797351,25/01/24,Tottenham,30,9,5,14,6,10,46,34,12,48
2797351,25/01/24,Manchester Blue,30,11,7,18,6,6,62,38,24,60
2797351,25/01/24,Bournemouth,30,8,4,12,9,9,32,29,3,45
2797351,25/01/24,West Ham,30,7,2,9,6,15,41,46,-5,33
2797351,25/01/24,Manchester Reds,30,13,7,20,3,7,46,27,19,63
2797351,25/01/24,Wolverhampton,30,6,4,10,5,15,20,29,-9,35
2797351,25/01/24,Watford,30,4,3,7,9,14,29,43,-14,30
2797351,25/01/24,London Guns,30,10,7,17,5,8,56,35,21,56
2797351,25/01/24,Everton,30,5,4,9,5,16,32,46,-14,32
2797351,25/01/24,Burnley,30,1,4,5,9,16,21,39,-18,24
2797351,25/01/24,Southampton,30,3,3,6,4,20,19,49,-30,22
2797351,25/01/24,Leicester,30,8,3,11,6,13,41,47,-6,39
2797351,25/01/24,Crystal Palace,30,6,5,11,6,13,39,42,-3,39
2797351,25/01/24,Newcastle,30,3,4,7,4,19,27,51,-24,25
2797375,25/01/24,Chelsea,30,8,6,14,9,7,45,23,22,51
2797375,25/01/24,Liverpool,30,10,7,17,8,5,51,16,35,59
2797375,25/01/24,Tottenham,30,9,3,12,11,7,43,32,11,47
2797375,25/01/24,Manchester Blue,30,8,7,15,6,9,60,39,21,51
2797375,25/01/24,Bournemouth,30,12,7,19,2,9,48,33,15,59
2797375,25/01/24,West Ham,30,3,3,6,6,18,30,57,-27,24
2797375,25/01/24,Manchester Reds,30,11,5,16,4,10,49,35,14,52
2797375,25/01/24,Wolverhampton,30,6,3,9,10,11,28,38,-10,37
2797375,25/01/24,Watford,30,4,2,6,11,13,24,40,-16,29
2797375,25/01/24,London Guns,30,6,8,14,6,10,48,35,13,48
2797375,25/01/24,Everton,30,4,6,10,6,14,38,51,-13,36
2797375,25/01/24,Burnley,30,6,1,7,8,15,19,35,-16,29
2797375,25/01/24,Southampton,30,4,1,5,10,15,25,42,-17,25
2797375,25/01/24,Leicester,30,8,4,12,7,11,40,44,-4,43
2797375,25/01/24,Crystal Palace,30,6,4,10,6,14,33,46,-13,36
2797375,25/01/24,Newcastle,30,7,3,10,6,14,32,47,-15,36
2797400,26/01/24,Chelsea,30,11,4,15,6,9,45,33,12,51
2797400,26/01/24,Liverpool,30,9,8,17,8,5,48,22,26,59
2797400,26/01/24,Tottenham,30,10,6,16,5,9,68,42,26,53
2797400,26/01/24,Manchester Blue,30,9,7,16,9,5,64,36,28,57
2797400,26/01/24,Bournemouth,30,10,4,14,4,12,38,38,0,46
2797400,26/01/24,West Ham,30,8,1,9,4,17,32,61,-29,31
2797400,26/01/24,Manchester Reds,30,10,3,13,7,10,46,32,14,46
2797400,26/01/24,Wolverhampton,30,6,6,12,11,7,33,25,8,47
2797400,26/01/24,Watford,30,10,7,17,3,10,38,26,12,54
2797400,26/01/24,London Guns,30,9,6,15,6,9,56,31,25,51
2797400,26/01/24,Everton,30,7,4,11,7,12,44,51,-7,40
2797400,26/01/24,Burnley,30,2,4,6,14,10,16,35,-19,32
2797400,26/01/24,Southampton,30,3,1,4,4,22,20,49,-29,16
2797400,26/01/24,Leicester,30,8,4,12,9,9,41,41,0,45
2797400,26/01/24,Crystal Palace,30,3,1,4,9,17,26,55,-29,21
2797400,26/01/24,Newcastle,30,0,3,3,6,21,22,60,-38,15
2797430,26/01/24,Chelsea,30,9,10,19,6,5,53,24,29,63
2797430,26/01/24,Liverpool,30,6,7,13,8,9,43,31,12,47
2797430,26/01/24,Tottenham,30,9,5,14,7,9,50,34,16,49
2797430,26/01/24,Manchester Blue,30,7,7,14,11,5,59,40,19,53
2797430,26/01/24,Bournemouth,30,6,4,10,12,8,36,30,6,42
2797430,26/01/24,West Ham,30,4,1,5,7,18,28,49,-21,22
2797430,26/01/24,Manchester Reds,30,8,6,14,11,5,49,27,22,53
2797430,26/01/24,Wolverhampton,30,7,6,13,7,10,35,30,5,46
2797430,26/01/24,Watford,30,4,2,6,10,14,30,48,-18,28
2797430,26/01/24,London Guns,30,13,6,19,6,5,54,24,30,63
2797430,26/01/24,Everton,30,3,3,6,10,14,33,52,-19,28
2797430,26/01/24,Burnley,30,4,3,7,10,13,21,40,-19,31
2797430,26/01/24,Southampton,30,6,6,12,6,12,35,42,-7,42
2797430,26/01/24,Leicester,30,8,2,10,6,14,41,46,-5,36
2797430,26/01/24,Crystal Palace,30,4,5,9,5,16,35,44,-9,32
2797430,26/01/24,Newcastle,30,5,2,7,2,21,24,65,-41,23
2797453,26/01/24,Chelsea,30,10,9,19,4,7,67,36,31,61
2797453,26/01/24,Liverpool,30,9,6,15,7,8,46,33,13,52
2797453,26/01/24,Tottenham,30,11,4,15,7,8,50,35,15,52
2797453,26/01/24,Manchester Blue,30,12,7,19,7,4,69,33,36,64
2797453,26/01/24,Bournemouth,30,7,1,8,12,10,35,36,-1,36
2797453,26/01/24,West Ham,30,3,0,3,9,18,28,57,-29,18
2797453,26/01/24,Manchester Reds,30,7,5,12,6,12,42,41,1,42
2797453,26/01/24,Wolverhampton,30,8,3,11,9,10,41,34,7,42
2797453,26/01/24,Watford,30,6,6,12,7,11,35,44,-9,43
2797453,26/01/24,London Guns,30,8,5,13,8,9,54,38,16,47
2797453,26/01/24,Everton,30,5,6,11,7,12,41,52,-11,40
2797453,26/01/24,Burnley,30,3,4,7,12,11,24,33,-9,33
2797453,26/01/24,Southampton,30,4,0,4,15,11,24,38,-14,27
2797453,26/01/24,Leicester,30,5,5,10,7,13,42,51,-9,37
2797453,26/01/24,Crystal Palace,30,3,5,8,9,13,29,41,-12,33
2797453,26/01/24,Newcastle,30,4,1,5,10,15,28,53,-25,25
2797479,26/01/24,Chelsea,30,8,8,16,7,7,47,35,12,55
2797479,26/01/24,Liverpool,30,9,9,18,5,7,48,29,19,59
2797479,26/01/24,Tottenham,30,8,2,10,5,15,33,37,-4,35
2797479,26/01/24,Manchester Blue,30,7,6,13,8,9,49,35,14,47
2797479,26/01/24,Bournemouth,30,6,6,12,10,8,39,27,12,46
2797479,26/01/24,West Ham,30,5,4,9,9,12,31,35,-4,36
2797479,26/01/24,Manchester Reds,30,10,6,16,5,9,40,29,11,53
2797479,26/01/24,Wolverhampton,30,6,6,12,7,11,28,31,-3,43
2797479,26/01/24,Watford,30,6,3,9,12,9,32,32,0,39
2797479,26/01/24,London Guns,30,9,9,18,7,5,51,28,23,61
2797479,26/01/24,Everton,30,6,5,11,6,13,35,36,-1,39
2797479,26/01/24,Burnley,30,4,2,6,11,13,19,36,-17,29
2797479,26/01/24,Southampton,30,6,1,7,8,15,20,35,-15,29
2797479,26/01/24,Leicester,30,1,3,4,12,14,28,47,-19,24
2797479,26/01/24,Crystal Palace,30,4,5,9,7,14,32,43,-11,34
2797479,26/01/24,Newcastle,30,4,3,7,7,16,25,42,-17,28
2797504,26/01/24,Chelsea,30,10,6,16,5,9,58,31,27,53
2797504,26/01/24,Liverpool,30,10,5,15,5,10,35,26,9,50
2797504,26/01/24,Tottenham,30,7,3,10,6,14,38,42,-4,36
2797504,26/01/24,Manchester Blue,30,9,8,17,7,6,57,28,29,58
2797504,26/01/24,Bournemouth,30,8,8,16,9,5,45,28,17,57
2797504,26/01/24,West Ham,30,6,4,10,10,10,29,34,-5,40
2797504,26/01/24,Manchester Reds,30,11,5,16,6,8,53,37,16,54
2797504,26/01/24,Wolverhampton,30,8,5,13,7,10,36,29,7,46
2797504,26/01/24,Watford,30,5,6,11,7,12,28,34,-6,40
2797504,26/01/24,London Guns,30,11,6,17,4,9,50,31,19,55
2797504,26/01/24,Everton,30,6,6,12,8,10,33,32,1,44
2797504,26/01/24,Burnley,30,3,2,5,9,16,22,37,-15,24
2797504,26/01/24,Southampton,30,4,1,5,8,17,24,47,-23,23
2797504,26/01/24,Leicester,30,10,5,15,2,13,32,45,-13,47
2797504,26/01/24,Crystal Palace,30,2,1,3,10,17,28,54,-26,19
2797504,26/01/24,Newcastle,30,2,0,2,11,17,30,63,-33,17
2797529,26/01/24,Chelsea,30,8,5,13,11,6,49,30,19,50
2797529,26/01/24,Liverpool,30,9,7,16,8,6,54,30,24,56
2797529,26/01/24,Tottenham,30,9,1,10,8,12,42,43,-1,38
2797529,26/01/24,Manchester Blue,30,7,6,13,10,7,48,40,8,49
2797529,26/01/24,Bournemouth,30,10,3,13,11,6,46,28,18,50
2797529,26/01/24,West Ham,30,3,3,6,10,14,25,44,-19,28
2797529,26/01/24,Manchester Reds,30,10,4,14,7,9,43,40,3,49
2797529,26/01/24,Wolverhampton,30,7,5,12,10,8,41,32,9,46
2797529,26/01/24,Watford,30,7,2,9,9,12,37,42,-5,36
2797529,26/01/24,London Guns,30,12,6,18,8,4,56,29,27,62
2797529,26/01/24,Everton,30,7,2,9,7,14,30,45,-15,34
2797529,26/01/24,Burnley,30,5,1,6,9,15,24,44,-20,27
2797529,26/01/24,Southampton,30,8,3,11,9,10,32,38,-6,42
2797529,26/01/24,Leicester,30,8,4,12,5,13,50,44,6,41
2797529,26/01/24,Crystal Palace,30,6,0,6,10,14,32,44,-12,28
2797529,26/01/24,Newcastle,30,1,2,3,6,21,18,54,-36,15
2797555,26/01/24,Chelsea,30,11,6,17,6,7,41,27,14,57
2797555,26/01/24,Liverpool,30,10,5,15,8,7,44,31,13,53
2797555,26/01/24,Tottenham,30,8,8,16,4,10,48,31,17,52
2797555,26/01/24,Manchester Blue,30,7,9,16,5,9,53,34,19,53
2797555,26/01/24,Bournemouth,30,6,7,13,10,7,45,32,13,49
2797555,26/01/24,West Ham,30,5,2,7,7,16,31,42,-11,28
2797555,26/01/24,Manchester Reds,30,11,4,15,6,9,42,26,16,51
2797555,26/01/24,Wolverhampton,30,5,2,7,9,14,29,36,-7,30
2797555,26/01/24,Watford,30,6,2,8,6,16,24,39,-15,30
2797555,26/01/24,London Guns,30,12,6,18,4,8,51,33,18,58
2797555,26/01/24,Everton,30,6,4,10,10,10,34,43,-9,40
2797555,26/01/24,Burnley,30,6,3,9,4,17,26,43,-17,31
2797555,26/01/24,Southampton,30,4,1,5,7,18,17,47,-30,22
2797555,26/01/24,Leicester,30,9,5,14,4,12,38,37,1,46
2797555,26/01/24,Crystal Palace,30,6,4,10,8,12,32,39,-7,38
2797555,26/01/24,Newcastle,30,6,3,9,4,17,32,47,-15,31
2797585,26/01/24,Chelsea,30,9,8,17,8,5,46,24,22,59
2797585,26/01/24,Liverpool,30,6,5,11,11,8,45,34,11,44
2797585,26/01/24,Tottenham,30,5,9,14,13,3,47,26,21,55
2797585,26/01/24,Manchester Blue,30,9,2,11,7,12,39,38,1,40
2797585,26/01/24,Bournemouth,30,6,4,10,10,10,30,26,4,40
2797585,26/01/24,West Ham,30,5,5,10,5,15,35,53,-18,35
2797585,26/01/24,Manchester Reds,30,7,4,11,10,9,39,31,8,43
2797585,26/01/24,Wolverhampton,30,9,3,12,10,8,40,32,8,46
2797585,26/01/24,Watford,30,7,3,10,10,10,30,34,-4,40
2797585,26/01/24,London Guns,30,9,4,13,12,5,50,29,21,51
2797585,26/01/24,Everton,30,4,2,6,13,11,32,47,-15,31
2797585,26/01/24,Burnley,30,2,2,4,11,15,24,40,-16,23
2797585,26/01/24,Southampton,30,7,3,10,5,15,34,42,-8,35
2797585,26/01/24,Leicester,30,8,4,12,9,9,45,44,1,45
2797585,26/01/24,Crystal Palace,30,3,2,5,11,14,27,45,-18,26
2797585,26/01/24,Newcastle,30,5,3,8,7,15,19,37,-18,31
2797607,26/01/24,Chelsea,30,10,8,18,7,5,56,25,31,61
2797607,26/01/24,Liverpool,30,9,8,17,9,4,53,28,25,60
2797607,26/01/24,Tottenham,30,7,6,13,6,11,45,39,6,45
2797607,26/01/24,Manchester Blue,30,13,8,21,6,3,64,28,36,69
2797607,26/01/24,Bournemouth,30,8,5,13,8,9,41,35,6,47
2797607,26/01/24,West Ham,30,5,0,5,7,18,23,53,-30,22
2797607,26/01/24,Manchester Reds,30,8,4,12,6,12,38,36,2,42
2797607,26/01/24,Wolverhampton,30,6,5,11,13,6,34,29,5,46
2797607,26/01/24,Watford,30,4,3,7,10,13,34,41,-7,31
2797607,26/01/24,London Guns,30,8,3,11,9,10,44,38,6,42
2797607,26/01/24,Everton,30,10,2,12,5,13,45,45,0,41
2797607,26/01/24,Burnley,30,4,4,8,4,18,24,54,-30,28
2797607,26/01/24,Southampton,30,3,1,4,10,16,23,42,-19,22
2797607,26/01/24,Leicester,30,8,6,14,4,12,48,38,10,46
2797607,26/01/24,Crystal Palace,30,6,2,8,10,12,28,45,-17,34
2797607,26/01/24,Newcastle,30,4,1,5,8,17,22,46,-24,23
2797633,26/01/24,Chelsea,30,7,6,13,8,9,45,36,9,47
2797633,26/01/24,Liverpool,30,11,7,18,4,8,43,23,20,58
2797633,26/01/24,Tottenham,30,8,7,15,7,8,60,43,17,52
2797633,26/01/24,Manchester Blue,30,11,5,16,3,11,49,35,14,51
2797633,26/01/24,Bournemouth,30,7,3,10,11,9,40,39,1,41
2797633,26/01/24,West Ham,30,8,4,12,10,8,43,41,2,46
2797633,26/01/24,Manchester Reds,30,7,7,14,7,9,40,31,9,49
2797633,26/01/24,Wolverhampton,30,6,8,14,7,9,31,25,6,49
2797633,26/01/24,Watford,30,3,5,8,8,14,24,38,-14,32
2797633,26/01/24,London Guns,30,7,8,15,9,6,42,26,16,54
2797633,26/01/24,Everton,30,6,5,11,5,14,34,40,-6,38
2797633,26/01/24,Burnley,30,2,2,4,12,14,22,31,-9,24
2797633,26/01/24,Southampton,30,2,1,3,7,20,19,42,-23,16
2797633,26/01/24,Leicester,30,7,2,9,7,14,36,52,-16,34
2797633,26/01/24,Crystal Palace,30,4,4,8,11,11,32,41,-9,35
2797633,26/01/24,Newcastle,30,4,5,9,6,15,32,49,-17,33
2797658,26/01/24,Chelsea,30,10,6,16,5,9,59,32,27,53
2797658,26/01/24,Liverpool,30,11,9,20,7,3,58,24,34,67
2797658,26/01/24,Tottenham,30,8,7,15,8,7,55,37,18,53
2797658,26/01/24,Manchester Blue,30,9,4,13,7,10,62,43,19,46
2797658,26/01/24,Bournemouth,30,9,8,17,8,5,54,32,22,59
2797658,26/01/24,West Ham,30,4,1,5,11,14,38,55,-17,26
2797658,26/01/24,Manchester Reds,30,9,4,13,8,9,45,37,8,47
2797658,26/01/24,Wolverhampton,30,5,4,9,10,11,32,32,0,37
2797658,26/01/24,Watford,30,7,6,13,5,12,38,40,-2,44
2797658,26/01/24,London Guns,30,12,6,18,5,7,59,38,21,59
2797658,26/01/24,Everton,30,7,6,13,5,12,40,47,-7,44
2797658,26/01/24,Burnley,30,3,2,5,4,21,20,49,-29,19
2797658,26/01/24,Southampton,30,4,3,7,6,17,29,54,-25,27
2797658,26/01/24,Leicester,30,4,6,10,5,15,34,48,-14,35
2797658,26/01/24,Crystal Palace,30,3,1,4,7,19,22,57,-35,19
2797658,26/01/24,Newcastle,30,4,3,7,9,14,21,41,-20,30
2797683,26/01/24,Chelsea,30,6,6,12,13,5,47,34,13,49
2797683,26/01/24,Liverpool,30,13,5,18,6,6,52,26,26,60
2797683,26/01/24,Tottenham,30,8,7,15,9,6,50,32,18,54
2797683,26/01/24,Manchester Blue,30,10,7,17,8,5,51,26,25,59
2797683,26/01/24,Bournemouth,30,9,6,15,5,10,43,29,14,50
2797683,26/01/24,West Ham,30,5,4,9,5,16,31,44,-13,32
2797683,26/01/24,Manchester Reds,30,8,4,12,5,13,37,38,-1,41
2797683,26/01/24,Wolverhampton,30,7,3,10,8,12,29,33,-4,38
2797683,26/01/24,Watford,30,5,3,8,6,16,27,47,-20,30
2797683,26/01/24,London Guns,30,5,9,14,6,10,45,36,9,48
2797683,26/01/24,Everton,30,6,5,11,8,11,35,38,-3,41
2797683,26/01/24,Burnley,30,5,3,8,5,17,24,35,-11,29
2797683,26/01/24,Southampton,30,4,5,9,8,13,26,47,-21,35
2797683,26/01/24,Leicester,30,10,5,15,2,13,51,43,8,47
2797683,26/01/24,Crystal Palace,30,3,3,6,7,17,35,55,-20,25
2797683,26/01/24,Newcastle,30,3,3,6,9,15,17,37,-20,27
2797707,26/01/24,Chelsea,30,8,10,18,9,3,50,24,26,63
2797707,26/01/24,Liverpool,30,9,4,13,11,6,42,26,16,50
2797707,26/01/24,Tottenham,30,9,4,13,11,6,52,34,18,50
2797707,26/01/24,Manchester Blue,30,8,7,15,9,6,50,27,23,54
2797707,26/01/24,Bournemouth,30,9,6,15,7,8,49,30,19,52
2797707,26/01/24,West Ham,30,4,4,8,9,13,34,48,-14,33
2797707,26/01/24,Manchester Reds,30,6,4,10,12,8,47,43,4,42
2797707,26/01/24,Wolverhampton,30,9,2,11,9,10,32,32,0,42
2797707,26/01/24,Watford,30,3,1,4,11,15,23,41,-18,23
2797707,26/01/24,London Guns,30,7,4,11,9,10,47,35,12,42
2797707,26/01/24,Everton,30,5,5,10,12,8,38,37,1,42
2797707,26/01/24,Burnley,30,6,0,6,9,15,26,43,-17,27
2797707,26/01/24,Southampton,30,5,3,8,8,14,24,35,-11,32
2797707,26/01/24,Leicester,30,5,2,7,8,15,37,60,-23,29
2797707,26/01/24,Crystal Palace,30,7,4,11,6,13,36,49,-13,39
2797707,26/01/24,Newcastle,30,4,1,5,10,15,31,54,-23,25
2797734,27/01/24,Chelsea,30,13,9,22,5,3,66,20,46,71
2797734,27/01/24,Liverpool,30,8,8,16,4,10,48,30,18,52
2797734,27/01/24,Tottenham,30,9,3,12,3,15,34,35,-1,39
2797734,27/01/24,Manchester Blue,30,9,9,18,8,4,60,22,38,62
2797734,27/01/24,Bournemouth,30,10,6,16,6,8,45,27,18,54
2797734,27/01/24,West Ham,30,6,2,8,8,14,24,39,-15,32
2797734,27/01/24,Manchester Reds,30,5,4,9,8,13,33,36,-3,35
2797734,27/01/24,Wolverhampton,30,7,2,9,12,9,32,30,2,39
2797734,27/01/24,Watford,30,9,4,13,2,15,36,43,-7,41
2797734,27/01/24,London Guns,30,7,8,15,11,4,39,20,19,56
2797734,27/01/24,Everton,30,4,5,9,10,11,36,49,-13,37
2797734,27/01/24,Burnley,30,6,3,9,8,13,22,35,-13,35
2797734,27/01/24,Southampton,30,4,4,8,4,18,21,40,-19,28
2797734,27/01/24,Leicester,30,7,5,12,4,14,32,43,-11,40
2797734,27/01/24,Crystal Palace,30,2,2,4,7,19,17,59,-42,19
2797734,27/01/24,Newcastle,30,3,4,7,6,17,21,38,-17,27
2797766,27/01/24,Chelsea,30,10,6,16,6,8,44,26,18,54
2797766,27/01/24,Liverpool,30,12,6,18,8,4,59,26,33,62
2797766,27/01/24,Tottenham,30,9,6,15,6,9,55,39,16,51
2797766,27/01/24,Manchester Blue,30,12,6,18,8,4,66,25,41,62
2797766,27/01/24,Bournemouth,30,5,4,9,10,11,43,46,-3,37
2797766,27/01/24,West Ham,30,3,3,6,7,17,26,55,-29,25
2797766,27/01/24,Manchester Reds,30,9,6,15,7,8,41,35,6,52
2797766,27/01/24,Wolverhampton,30,7,6,13,8,9,31,26,5,47
2797766,27/01/24,Watford,30,6,4,10,8,12,31,47,-16,38
2797766,27/01/24,London Guns,30,10,6,16,5,9,50,29,21,53
2797766,27/01/24,Everton,30,4,2,6,9,15,28,50,-22,27
2797766,27/01/24,Burnley,30,2,3,5,8,17,20,41,-21,23
2797766,27/01/24,Southampton,30,5,2,7,7,16,24,44,-20,28
2797766,27/01/24,Leicester,30,4,1,5,12,13,40,48,-8,27
2797766,27/01/24,Crystal Palace,30,5,8,13,5,12,35,38,-3,44
2797766,27/01/24,Newcastle,30,7,2,9,4,17,27,45,-18,31
2797791,27/01/24,Chelsea,30,9,7,16,6,8,41,34,7,54
2797791,27/01/24,Liverpool,30,9,9,18,7,5,57,27,30,61
2797791,27/01/24,Tottenham,30,8,7,15,7,8,51,34,17,52
2797791,27/01/24,Manchester Blue,30,10,7,17,5,8,58,30,28,56
2797791,27/01/24,Bournemouth,30,8,7,15,9,6,34,22,12,54
2797791,27/01/24,West Ham,30,4,3,7,10,13,29,37,-8,31
2797791,27/01/24,Manchester Reds,30,7,8,15,8,7,51,27,24,53
2797791,27/01/24,Wolverhampton,30,4,7,11,8,11,39,35,4,41
2797791,27/01/24,Watford,30,6,7,13,5,12,34,43,-9,44
2797791,27/01/24,London Guns,30,6,4,10,11,9,40,41,-1,41
2797791,27/01/24,Everton,30,4,3,7,10,13,41,47,-6,31
2797791,27/01/24,Burnley,30,3,0,3,14,13,18,41,-23,23
2797791,27/01/24,Southampton,30,2,4,6,13,11,22,36,-14,31
2797791,27/01/24,Leicester,30,7,4,11,7,12,43,55,-12,40
2797791,27/01/24,Crystal Palace,30,4,2,6,9,15,28,45,-17,27
2797791,27/01/24,Newcastle,30,1,1,2,7,21,22,54,-32,13
2797815,27/01/24,Chelsea,30,8,7,15,8,7,43,25,18,53
2797815,27/01/24,Liverpool,30,6,6,12,7,11,52,38,14,43
2797815,27/01/24,Tottenham,30,7,7,14,9,7,41,27,14,51
2797815,27/01/24,Manchester Blue,30,8,5,13,7,10,47,38,9,46
2797815,27/01/24,Bournemouth,30,8,8,16,9,5,49,28,21,57
2797815,27/01/24,West Ham,30,3,3,6,11,13,27,51,-24,29
2797815,27/01/24,Manchester Reds,30,11,10,21,7,2,58,24,34,70
2797815,27/01/24,Wolverhampton,30,8,5,13,4,13,39,37,2,43
2797815,27/01/24,Watford,30,3,1,4,10,16,25,47,-22,22
2797815,27/01/24,London Guns,30,9,10,19,8,3,54,19,35,65
2797815,27/01/24,Everton,30,3,6,9,8,13,35,46,-11,35
2797815,27/01/24,Burnley,30,6,0,6,9,15,31,48,-17,27
2797815,27/01/24,Southampton,30,5,2,7,9,14,26,41,-15,30
2797815,27/01/24,Leicester,30,3,3,6,9,15,33,53,-20,27
2797815,27/01/24,Crystal Palace,30,6,3,9,4,17,34,54,-20,31
2797815,27/01/24,Newcastle,30,4,2,6,9,15,27,45,-18,27
2797841,27/01/24,Chelsea,30,9,11,20,7,3,58,24,34,67
2797841,27/01/24,Liverpool,30,10,8,18,8,4,51,25,26,62
2797841,27/01/24,Tottenham,30,6,4,10,6,14,41,47,-6,36
2797841,27/01/24,Manchester Blue,30,10,10,20,2,8,64,33,31,62
2797841,27/01/24,Bournemouth,30,6,6,12,4,14,39,33,6,40
2797841,27/01/24,West Ham,30,3,0,3,7,20,18,49,-31,16
2797841,27/01/24,Manchester Reds,30,10,3,13,7,10,45,42,3,46
2797841,27/01/24,Wolverhampton,30,6,5,11,8,11,31,31,0,41
2797841,27/01/24,Watford,30,6,2,8,11,11,32,40,-8,35
2797841,27/01/24,London Guns,30,11,7,18,5,7,55,37,18,59
2797841,27/01/24,Everton,30,8,4,12,3,15,41,46,-5,39
2797841,27/01/24,Burnley,30,4,4,8,13,9,28,37,-9,37
2797841,27/01/24,Southampton,30,5,2,7,2,21,21,47,-26,23
2797841,27/01/24,Leicester,30,7,4,11,6,13,34,40,-6,39
2797841,27/01/24,Crystal Palace,30,8,2,10,8,12,37,38,-1,38
2797841,27/01/24,Newcastle,30,4,2,6,9,15,25,51,-26,27
2797865,27/01/24,Chelsea,30,8,8,16,11,3,55,25,30,59
2797865,27/01/24,Liverpool,30,10,11,21,3,6,54,24,30,66
2797865,27/01/24,Tottenham,30,8,6,14,6,10,38,35,3,48
2797865,27/01/24,Manchester Blue,30,11,6,17,8,5,61,30,31,59
2797865,27/01/24,Bournemouth,30,8,6,14,9,7,52,30,22,51
2797865,27/01/24,West Ham,30,1,2,3,10,17,22,51,-29,19
2797865,27/01/24,Manchester Reds,30,9,7,16,3,11,43,38,5,51
2797865,27/01/24,Wolverhampton,30,8,3,11,6,13,36,39,-3,39
2797865,27/01/24,Watford,30,5,2,7,8,15,34,40,-6,29
2797865,27/01/24,London Guns,30,10,12,22,4,4,56,25,31,70
2797865,27/01/24,Everton,30,5,8,13,6,11,43,42,1,45
2797865,27/01/24,Burnley,30,2,2,4,8,18,17,43,-26,20
2797865,27/01/24,Southampton,30,3,3,6,9,15,25,53,-28,27
2797865,27/01/24,Leicester,30,7,3,10,3,17,36,47,-11,33
2797865,27/01/24,Crystal Palace,30,1,2,3,5,22,21,60,-39,14
2797865,27/01/24,Newcastle,30,5,4,9,9,12,30,41,-11,36
2797889,27/01/24,Chelsea,30,9,7,16,6,8,48,30,18,54
2797889,27/01/24,Liverpool,30,11,7,18,4,8,47,28,19,58
2797889,27/01/24,Tottenham,30,11,6,17,3,10,49,27,22,54
2797889,27/01/24,Manchester Blue,30,9,8,17,10,3,55,27,28,61
2797889,27/01/24,Bournemouth,30,8,3,11,7,12,38,40,-2,40
2797889,27/01/24,West Ham,30,7,5,12,4,14,43,45,-2,40
2797889,27/01/24,Manchester Reds,30,10,5,15,3,12,40,34,6,48
2797889,27/01/24,Wolverhampton,30,6,4,10,10,10,26,25,1,40
2797889,27/01/24,Watford,30,5,6,11,10,9,38,34,4,43
2797889,27/01/24,London Guns,30,10,6,16,7,7,49,37,12,55
2797889,27/01/24,Everton,30,5,2,7,8,15,33,43,-10,29
2797889,27/01/24,Burnley,30,5,4,9,6,15,26,39,-13,33
2797889,27/01/24,Southampton,30,4,4,8,6,16,22,41,-19,30
2797889,27/01/24,Leicester,30,5,2,7,5,18,35,61,-26,26
2797889,27/01/24,Crystal Palace,30,2,3,5,10,15,26,48,-22,25
2797889,27/01/24,Newcastle,30,5,2,7,9,14,29,45,-16,30
2797918,27/01/24,Chelsea,30,9,10,19,5,6,57,30,27,62
2797918,27/01/24,Liverpool,30,11,10,21,3,6,54,26,28,66
2797918,27/01/24,Tottenham,30,10,5,15,6,9,45,33,12,51
2797918,27/01/24,Manchester Blue,30,13,9,22,3,5,57,27,30,69
2797918,27/01/24,Bournemouth,30,10,6,16,7,7,41,26,15,55
2797918,27/01/24,West Ham,30,5,4,9,8,13,32,40,-8,35
2797918,27/01/24,Manchester Reds,30,5,3,8,10,12,35,39,-4,34
2797918,27/01/24,Wolverhampton,30,3,4,7,12,11,28,37,-9,33
2797918,27/01/24,Watford,30,2,6,8,10,12,30,45,-15,34
2797918,27/01/24,London Guns,30,7,8,15,8,7,48,26,22,53
2797918,27/01/24,Everton,30,4,6,10,6,14,43,49,-6,36
2797918,27/01/24,Burnley,30,3,2,5,6,19,18,39,-21,21
2797918,27/01/24,Southampton,30,5,4,9,10,11,33,41,-8,37
2797918,27/01/24,Leicester,30,6,5,11,5,14,42,49,-7,38
2797918,27/01/24,Crystal Palace,30,1,2,3,8,19,19,57,-38,17
2797918,27/01/24,Newcastle,30,4,1,5,7,18,21,39,-18,22
2797944,27/01/24,Chelsea,30,7,6,13,8,9,48,39,9,47
2797944,27/01/24,Liverpool,30,10,6,16,10,4,48,22,26,58
2797944,27/01/24,Tottenham,30,8,7,15,4,11,55,44,11,49
2797944,27/01/24,Manchester Blue,30,11,5,16,7,7,49,27,22,55
2797944,27/01/24,Bournemouth,30,11,6,17,9,4,49,20,29,60
2797944,27/01/24,West Ham,30,4,3,7,10,13,26,39,-13,31
2797944,27/01/24,Manchester Reds,30,8,2,10,11,9,32,32,0,41
2797944,27/01/24,Wolverhampton,30,8,4,12,8,10,31,31,0,44
2797944,27/01/24,Watford,30,6,2,8,9,13,35,46,-11,33
2797944,27/01/24,London Guns,30,7,7,14,11,5,55,35,20,53
2797944,27/01/24,Everton,30,7,6,13,5,12,40,42,-2,44
2797944,27/01/24,Burnley,30,4,2,6,9,15,14,33,-19,27
2797944,27/01/24,Southampton,30,2,2,4,9,17,25,44,-19,21
2797944,27/01/24,Leicester,30,8,3,11,7,12,30,41,-11,40
2797944,27/01/24,Crystal Palace,30,6,4,10,4,16,33,42,-9,34
2797944,27/01/24,Newcastle,30,3,3,6,3,21,21,54,-33,21
2797969,27/01/24,Chelsea,30,10,7,17,6,7,58,30,28,57
2797969,27/01/24,Liverpool,30,11,8,19,8,3,63,28,35,65
2797969,27/01/24,Tottenham,30,6,5,11,9,10,44,40,4,42
2797969,27/01/24,Manchester Blue,30,10,7,17,4,9,49,30,19,55
2797969,27/01/24,Bournemouth,30,8,5,13,7,10,39,27,12,46
2797969,27/01/24,West Ham,30,4,3,7,7,16,28,46,-18,28
2797969,27/01/24,Manchester Reds,30,7,5,12,9,9,48,42,6,45
2797969,27/01/24,Wolverhampton,30,8,2,10,6,14,31,40,-9,36
2797969,27/01/24,Watford,30,10,3,13,8,9,40,35,5,47
2797969,27/01/24,London Guns,30,12,7,19,2,9,56,41,15,59
2797969,27/01/24,Everton,30,6,3,9,6,15,38,51,-13,33
2797969,27/01/24,Burnley,30,6,3,9,7,14,32,42,-10,34
2797969,27/01/24,Southampton,30,5,1,6,8,16,24,44,-20,26
2797969,27/01/24,Leicester,30,4,3,7,11,12,34,48,-14,32
2797969,27/01/24,Crystal Palace,30,1,3,4,5,21,28,65,-37,17
2797969,27/01/24,Newcastle,30,8,5,13,5,12,39,42,-3,44
2797996,27/01/24,Chelsea,30,10,5,15,5,10,47,36,11,50
2797996,27/01/24,Liverpool,30,10,6,16,7,7,59,29,30,55
2797996,27/01/24,Tottenham,30,9,3,12,8,10,41,37,4,44
2797996,27/01/24,Manchester Blue,30,10,6,16,8,6,56,31,25,56
2797996,27/01/24,Bournemouth,30,12,6,18,4,8,38,27,11,58
2797996,27/01/24,West Ham,30,3,3,6,8,16,23,51,-28,26
2797996,27/01/24,Manchester Reds,30,8,5,13,10,7,44,28,16,49
2797996,27/01/24,Wolverhampton,30,7,7,14,5,11,33,28,5,47
2797996,27/01/24,Watford,30,4,3,7,9,14,30,34,-4,30
2797996,27/01/24,London Guns,30,6,4,10,5,15,46,42,4,35
2797996,27/01/24,Everton,30,5,4,9,6,15,30,42,-12,33
2797996,27/01/24,Burnley,30,9,4,13,6,11,27,35,-8,45
2797996,27/01/24,Southampton,30,7,2,9,6,15,25,40,-15,33
2797996,27/01/24,Leicester,30,9,4,13,8,9,50,51,-1,47
2797996,27/01/24,Crystal Palace,30,5,3,8,7,15,29,48,-19,31
2797996,27/01/24,Newcastle,30,3,2,5,10,15,25,44,-19,25
2798021,27/01/24,Chelsea,30,11,6,17,5,8,48,27,21,56
2798021,27/01/24,Liverpool,30,9,9,18,7,5,59,27,32,61
2798021,27/01/24,Tottenham,30,10,4,14,8,8,56,41,15,50
2798021,27/01/24,Manchester Blue,30,11,7,18,7,5,55,23,32,61
2798021,27/01/24,Bournemouth,30,7,3,10,7,13,34,40,-6,37
2798021,27/01/24,West Ham,30,8,3,11,7,12,37,46,-9,40
2798021,27/01/24,Manchester Reds,30,12,4,16,7,7,44,27,17,55
2798021,27/01/24,Wolverhampton,30,9,9,18,6,6,39,30,9,60
2798021,27/01/24,Watford,30,7,3,10,6,14,36,42,-6,36
2798021,27/01/24,London Guns,30,9,6,15,10,5,56,36,20,55
2798021,27/01/24,Everton,30,6,3,9,8,13,36,40,-4,35
2798021,27/01/24,Burnley,30,4,5,9,8,13,20,31,-11,35
2798021,27/01/24,Southampton,30,3,1,4,6,20,21,51,-30,18
2798021,27/01/24,Leicester,30,5,3,8,7,15,37,53,-16,31
2798021,27/01/24,Crystal Palace,30,1,3,4,7,19,22,60,-38,19
2798021,27/01/24,Newcastle,30,1,1,2,8,20,21,47,-26,14
2798045,27/01/24,Chelsea,30,8,9,17,7,6,39,21,18,58
2798045,27/01/24,Liverpool,30,7,8,15,10,5,51,36,15,55
2798045,27/01/24,Tottenham,30,4,5,9,10,11,40,41,-1,37
2798045,27/01/24,Manchester Blue,30,9,9,18,6,6,60,28,32,60
2798045,27/01/24,Bournemouth,30,7,4,11,5,14,39,41,-2,38
2798045,27/01/24,West Ham,30,5,5,10,5,15,35,44,-9,35
2798045,27/01/24,Manchester Reds,30,7,10,17,6,7,52,27,25,57
2798045,27/01/24,Wolverhampton,30,3,5,8,10,12,27,33,-6,34
2798045,27/01/24,Watford,30,5,4,9,10,11,30,38,-8,37
2798045,27/01/24,London Guns,30,6,10,16,8,6,53,34,19,56
2798045,27/01/24,Everton,30,6,6,12,7,11,35,34,1,43
2798045,27/01/24,Burnley,30,5,4,9,6,15,29,41,-12,33
2798045,27/01/24,Southampton,30,7,4,11,6,13,25,37,-12,39
2798045,27/01/24,Leicester,30,3,3,6,5,19,38,63,-25,23
2798045,27/01/24,Crystal Palace,30,3,3,6,8,16,25,46,-21,26
2798045,27/01/24,Newcastle,30,5,2,7,9,14,21,35,-14,30
2798073,28/01/24,Chelsea,30,8,9,17,8,5,39,18,21,59
2798073,28/01/24,Liverpool,30,12,6,18,3,9,53,32,21,57
2798073,28/01/24,Tottenham,30,7,6,13,8,9,43,35,8,47
2798073,28/01/24,Manchester Blue,30,10,10,20,6,4,62,23,39,66
2798073,28/01/24,Bournemouth,30,9,4,13,9,8,41,27,14,48
2798073,28/01/24,West Ham,30,7,3,10,5,15,25,35,-10,35
2798073,28/01/24,Manchester Reds,30,6,5,11,10,9,41,38,3,43
2798073,28/01/24,Wolverhampton,30,8,5,13,4,13,30,39,-9,43
2798073,28/01/24,Watford,30,8,3,11,5,14,31,46,-15,38
2798073,28/01/24,London Guns,30,6,4,10,10,10,46,43,3,40
2798073,28/01/24,Everton,30,5,5,10,5,15,38,47,-9,35
2798073,28/01/24,Burnley,30,0,1,1,14,15,9,36,-27,17
2798073,28/01/24,Southampton,30,3,2,5,10,15,21,42,-21,25
2798073,28/01/24,Leicester,30,6,5,11,8,11,41,42,-1,41
2798073,28/01/24,Crystal Palace,30,5,2,7,10,13,39,45,-6,31
2798073,28/01/24,Newcastle,30,3,4,7,11,12,31,42,-11,32
2798099,28/01/24,Chelsea,30,7,5,12,11,7,48,32,16,47
2798099,28/01/24,Liverpool,30,9,4,13,9,8,52,28,24,48
2798099,28/01/24,Tottenham,30,8,6,14,8,8,61,33,28,50
2798099,28/01/24,Manchester Blue,30,13,1,14,8,8,52,38,14,50
2798099,28/01/24,Bournemouth,30,11,5,16,5,9,45,32,13,53
2798099,28/01/24,West Ham,30,7,2,9,6,15,32,58,-26,33
2798099,28/01/24,Manchester Reds,30,9,4,13,11,6,48,32,16,50
2798099,28/01/24,Wolverhampton,30,5,3,8,12,10,23,31,-8,36
2798099,28/01/24,Watford,30,6,4,10,6,14,37,49,-12,36
2798099,28/01/24,London Guns,30,11,7,18,7,5,61,29,32,61
2798099,28/01/24,Everton,30,4,5,9,10,11,38,41,-3,37
2798099,28/01/24,Burnley,30,3,3,6,8,16,22,51,-29,26
2798099,28/01/24,Southampton,30,2,4,6,8,16,25,45,-20,26
2798099,28/01/24,Leicester,30,5,5,10,5,15,33,47,-14,35
2798099,28/01/24,Crystal Palace,30,5,2,7,13,10,36,49,-13,34
2798099,28/01/24,Newcastle,30,3,4,7,9,14,31,49,-18,30
2798122,28/01/24,Chelsea,30,12,6,18,3,9,54,27,27,57
2798122,28/01/24,Liverpool,30,11,6,17,9,4,49,26,23,60
2798122,28/01/24,Tottenham,30,6,4,10,11,9,48,39,9,41
2798122,28/01/24,Manchester Blue,30,11,9,20,5,5,76,30,46,65
2798122,28/01/24,Bournemouth,30,6,4,10,6,14,27,33,-6,36
2798122,28/01/24,West Ham,30,3,1,4,12,14,27,56,-29,24
2798122,28/01/24,Manchester Reds,30,8,7,15,6,9,51,36,15,51
2798122,28/01/24,Wolverhampton,30,8,4,12,10,8,37,33,4,46
2798122,28/01/24,Watford,30,8,2,10,7,13,37,43,-6,37
2798122,28/01/24,London Guns,30,9,5,14,8,8,43,40,3,50
2798122,28/01/24,Everton,30,5,3,8,7,15,38,51,-13,31
2798122,28/01/24,Burnley,30,5,1,6,5,19,17,44,-27,23
2798122,28/01/24,Southampton,30,4,3,7,7,16,32,48,-16,28
2798122,28/01/24,Leicester,30,6,7,13,3,14,41,45,-4,42
2798122,28/01/24,Crystal Palace,30,4,3,7,7,16,26,44,-18,28
2798122,28/01/24,Newcastle,30,8,5,13,6,11,38,46,-8,45
2798148,28/01/24,Chelsea,30,11,10,21,7,2,47,16,31,70
2798148,28/01/24,Liverpool,30,7,4,11,8,11,43,34,9,41
2798148,28/01/24,Tottenham,30,11,3,14,9,7,56,40,16,51
2798148,28/01/24,Manchester Blue,30,11,7,18,6,6,65,31,34,60
2798148,28/01/24,Bournemouth,30,10,10,20,4,6,55,27,28,64
2798148,28/01/24,West Ham,30,3,4,7,7,16,27,54,-27,28
2798148,28/01/24,Manchester Reds,30,8,7,15,7,8,46,35,11,52
2798148,28/01/24,Wolverhampton,30,4,4,8,9,13,30,47,-17,33
2798148,28/01/24,Watford,30,8,3,11,10,9,41,32,9,43
2798148,28/01/24,London Guns,30,8,6,14,10,6,52,39,13,52
2798148,28/01/24,Everton,30,6,3,9,8,13,39,42,-3,35
2798148,28/01/24,Burnley,30,4,2,6,7,17,19,35,-16,25
2798148,28/01/24,Southampton,30,3,2,5,6,19,21,46,-25,21
2798148,28/01/24,Leicester,30,6,1,7,9,14,35,52,-17,30
2798148,28/01/24,Crystal Palace,30,4,3,7,9,14,32,59,-27,30
2798148,28/01/24,Newcastle,30,4,1,5,8,17,27,46,-19,23
2798174,28/01/24,Chelsea,30,11,8,19,8,3,56,27,29,65
2798174,28/01/24,Liverpool,30,9,4,13,6,11,44,28,16,45
2798174,28/01/24,Tottenham,30,8,7,15,12,3,52,26,26,57
2798174,28/01/24,Manchester Blue,30,10,10,20,3,7,56,36,20,63
2798174,28/01/24,Bournemouth,30,8,7,15,7,8,38,36,2,52
2798174,28/01/24,West Ham,30,4,3,7,8,15,27,48,-21,29
2798174,28/01/24,Manchester Reds,30,10,8,18,2,10,53,36,17,56
2798174,28/01/24,Wolverhampton,30,7,2,9,10,11,35,33,2,37
2798174,28/01/24,Watford,30,4,1,5,12,13,32,45,-13,27
2798174,28/01/24,London Guns,30,8,6,14,10,6,44,29,15,52
2798174,28/01/24,Everton,30,6,2,8,5,17,38,53,-15,29
2798174,28/01/24,Burnley,30,5,3,8,5,17,26,40,-14,29
2798174,28/01/24,Southampton,30,2,2,4,11,15,20,42,-22,23
2798174,28/01/24,Leicester,30,6,5,11,7,12,46,48,-2,40
2798174,28/01/24,Crystal Palace,30,2,2,4,12,14,29,51,-22,24
2798174,28/01/24,Newcastle,30,5,3,8,6,16,32,50,-18,30
2798200,28/01/24,Chelsea,30,10,8,18,5,7,55,26,29,59
2798200,28/01/24,Liverpool,30,10,8,18,7,5,56,27,29,61
2798200,28/01/24,Tottenham,30,10,7,17,4,9,48,37,11,55
2798200,28/01/24,Manchester Blue,30,9,8,17,3,10,62,36,26,54
2798200,28/01/24,Bournemouth,30,10,3,13,9,8,36,30,6,48
2798200,28/01/24,West Ham,30,5,3,8,8,14,29,44,-15,32
2798200,28/01/24,Manchester Reds,30,8,4,12,7,11,36,41,-5,43
2798200,28/01/24,Wolverhampton,30,9,9,18,3,9,44,25,19,57
2798200,28/01/24,Watford,30,7,5,12,3,15,38,45,-7,39
2798200,28/01/24,London Guns,30,9,10,19,4,7,59,33,26,61
2798200,28/01/24,Everton,30,5,5,10,10,10,38,37,1,40
2798200,28/01/24,Burnley,30,0,4,4,8,18,16,45,-29,20
2798200,28/01/24,Southampton,30,2,0,2,9,19,10,38,-28,15
2798200,28/01/24,Leicester,30,1,5,6,8,16,28,48,-20,26
2798200,28/01/24,Crystal Palace,30,4,2,6,7,17,27,59,-32,25
2798200,28/01/24,Newcastle,30,6,2,8,9,13,35,46,-11,33
2798223,28/01/24,Chelsea,30,10,7,17,9,4,49,22,27,60
2798223,28/01/24,Liverpool,30,9,5,14,8,8,57,33,24,50
2798223,28/01/24,Tottenham,30,10,6,16,7,7,55,33,22,55
2798223,28/01/24,Manchester Blue,30,10,8,18,5,7,62,36,26,59
2798223,28/01/24,Bournemouth,30,8,4,12,7,11,36,35,1,43
2798223,28/01/24,West Ham,30,5,0,5,6,19,29,50,-21,21
2798223,28/01/24,Manchester Reds,30,6,5,11,10,9,43,32,11,43
2798223,28/01/24,Wolverhampton,30,4,6,10,8,12,31,36,-5,38
2798223,28/01/24,Watford,30,6,2,8,8,14,28,36,-8,32
2798223,28/01/24,London Guns,30,10,7,17,8,5,45,28,17,59
2798223,28/01/24,Everton,30,6,6,12,8,10,37,39,-2,44
2798223,28/01/24,Burnley,30,4,3,7,8,15,25,45,-20,29
2798223,28/01/24,Southampton,30,4,1,5,10,15,19,42,-23,25
2798223,28/01/24,Leicester,30,9,0,9,9,12,35,52,-17,36
2798223,28/01/24,Crystal Palace,30,4,1,5,9,16,25,44,-19,24
2798223,28/01/24,Newcastle,30,7,4,11,6,13,34,47,-13,39
2798254,28/01/24,Chelsea,30,10,8,18,6,6,49,24,25,60
2798254,28/01/24,Liverpool,30,11,6,17,5,8,55,32,23,56
2798254,28/01/24,Tottenham,30,8,4,12,8,10,37,41,-4,44
2798254,28/01/24,Manchester Blue,30,7,6,13,6,11,54,45,9,45
2798254,28/01/24,Bournemouth,30,6,10,16,5,9,51,33,18,53
2798254,28/01/24,West Ham,30,6,2,8,6,16,31,43,-12,30
2798254,28/01/24,Manchester Reds,30,8,5,13,8,9,43,38,5,47
2798254,28/01/24,Wolverhampton,30,8,6,14,7,9,38,29,9,49
2798254,28/01/24,Watford,30,7,3,10,5,15,38,43,-5,35
2798254,28/01/24,London Guns,30,6,9,15,5,10,53,45,8,50
2798254,28/01/24,Everton,30,9,2,11,6,13,34,35,-1,39
2798254,28/01/24,Burnley,30,5,3,8,3,19,21,43,-22,27
2798254,28/01/24,Southampton,30,5,4,9,5,16,21,37,-16,32
2798254,28/01/24,Leicester,30,8,5,13,6,11,42,44,-2,45
2798254,28/01/24,Crystal Palace,30,6,3,9,4,17,30,50,-20,31
2798254,28/01/24,Newcastle,30,4,5,9,5,16,34,49,-15,32
2798276,28/01/24,Chelsea,30,9,8,17,5,8,47,29,18,56
2798276,28/01/24,Liverpool,30,12,6,18,6,6,58,30,28,60
2798276,28/01/24,Tottenham,30,6,3,9,9,12,36,42,-6,36
2798276,28/01/24,Manchester Blue,30,11,8,19,9,2,62,25,37,66
2798276,28/01/24,Bournemouth,30,8,6,14,9,7,40,28,12,51
2798276,28/01/24,West Ham,30,6,6,12,8,10,46,38,8,44
2798276,28/01/24,Manchester Reds,30,9,7,16,5,9,43,35,8,53
2798276,28/01/24,Wolverhampton,30,4,2,6,15,9,20,30,-10,33
2798276,28/01/24,Watford,30,6,1,7,4,19,30,53,-23,25
2798276,28/01/24,London Guns,30,9,6,15,2,13,46,31,15,47
2798276,28/01/24,Everton,30,4,3,7,8,15,30,41,-11,29
2798276,28/01/24,Burnley,30,6,4,10,10,10,29,35,-6,40
2798276,28/01/24,Southampton,30,6,2,8,6,16,23,42,-19,30
2798276,28/01/24,Leicester,30,6,5,11,8,11,42,46,-4,41
2798276,28/01/24,Crystal Palace,30,6,1,7,6,17,28,50,-22,27
2798276,28/01/24,Newcastle,30,4,0,4,10,16,23,48,-25,22
2798303,28/01/24,Chelsea,30,11,6,17,6,7,42,24,18,57
2798303,28/01/24,Liverpool,30,8,5,13,9,8,50,29,21,48
2798303,28/01/24,Tottenham,30,8,7,15,5,10,50,37,13,50
2798303,28/01/24,Manchester Blue,30,7,6,13,7,10,57,38,19,46
2798303,28/01/24,Bournemouth,30,11,4,15,7,8,47,40,7,52
2798303,28/01/24,West Ham,30,5,1,6,7,17,29,55,-26,25
2798303,28/01/24,Manchester Reds,30,9,8,17,4,9,50,34,16,55
2798303,28/01/24,Wolverhampton,30,8,7,15,11,4,33,18,15,56
2798303,28/01/24,Watford,30,7,4,11,4,15,43,46,-3,37
2798303,28/01/24,London Guns,30,9,8,17,3,10,56,33,23,54
2798303,28/01/24,Everton,30,6,1,7,9,14,34,58,-24,30
2798303,28/01/24,Burnley,30,4,3,7,7,16,23,46,-23,28
2798303,28/01/24,Southampton,30,9,1,10,6,14,30,46,-16,36
2798303,28/01/24,Leicester,30,6,4,10,10,10,53,48,5,40
2798303,28/01/24,Crystal Palace,30,4,2,6,12,12,32,47,-15,30
2798303,28/01/24,Newcastle,30,3,1,4,7,19,20,50,-30,19
2798325,28/01/24,Chelsea,30,8,8,16,7,7,45,28,17,55
2798325,28/01/24,Liverpool,30,13,9,22,7,1,59,24,35,73
2798325,28/01/24,Tottenham,30,7,4,11,6,13,55,50,5,39
2798325,28/01/24,Manchester Blue,30,10,7,17,5,8,47,33,14,56
2798325,28/01/24,Bournemouth,30,12,7,19,4,7,44,21,23,61
2798325,28/01/24,West Ham,30,4,3,7,5,18,30,43,-13,26
2798325,28/01/24,Manchester Reds,30,6,5,11,4,15,43,46,-3,37
2798325,28/01/24,Wolverhampton,30,8,4,12,6,12,37,37,0,42
2798325,28/01/24,Watford,30,6,6,12,6,12,36,35,1,42
2798325,28/01/24,London Guns,30,8,6,14,5,11,48,37,11,47
2798325,28/01/24,Everton,30,2,4,6,8,16,32,49,-17,26
2798325,28/01/24,Burnley,30,5,5,10,7,13,28,35,-7,37
2798325,28/01/24,Southampton,30,3,4,7,11,12,27,47,-20,32
2798325,28/01/24,Leicester,30,8,3,11,5,14,41,53,-12,38
2798325,28/01/24,Crystal Palace,30,5,1,6,5,19,34,59,-25,23
2798325,28/01/24,Newcastle,30,4,5,9,9,12,31,40,-9,36
2798353,28/01/24,Chelsea,30,8,4,12,5,13,41,36,5,41
2798353,28/01/24,Liverpool,30,12,8,20,6,4,49,17,32,66
2798353,28/01/24,Tottenham,30,9,3,12,7,11,47,38,9,43
2798353,28/01/24,Manchester Blue,30,12,6,18,4,8,65,33,32,58
2798353,28/01/24,Bournemouth,30,11,6,17,6,7,49,29,20,57
2798353,28/01/24,West Ham,30,2,3,5,6,19,20,53,-33,21
2798353,28/01/24,Manchester Reds,30,9,7,16,5,9,47,28,19,53
2798353,28/01/24,Wolverhampton,30,7,6,13,7,10,40,37,3,46
2798353,28/01/24,Watford,30,7,5,12,6,12,41,43,-2,42
2798353,28/01/24,London Guns,30,10,6,16,9,5,60,33,27,57
2798353,28/01/24,Everton,30,6,5,11,9,10,39,42,-3,42
2798353,28/01/24,Burnley,30,6,3,9,8,13,24,38,-14,35
2798353,28/01/24,Southampton,30,4,4,8,10,12,25,43,-18,34
2798353,28/01/24,Leicester,30,4,1,5,5,20,35,65,-30,20
2798353,28/01/24,Crystal Palace,30,6,3,9,10,11,39,47,-8,37
2798353,28/01/24,Newcastle,30,2,1,3,5,22,16,55,-39,14
2798377,28/01/24,Chelsea,30,9,2,11,11,8,41,39,2,44
2798377,28/01/24,Liverpool,30,12,9,21,4,5,54,23,31,67
2798377,28/01/24,Tottenham,30,11,9,20,2,8,62,31,31,62
2798377,28/01/24,Manchester Blue,30,8,6,14,9,7,55,40,15,51
2798377,28/01/24,Bournemouth,30,11,6,17,4,9,45,28,17,55
2798377,28/01/24,West Ham,30,6,1,7,4,19,28,45,-17,25
2798377,28/01/24,Manchester Reds,30,8,3,11,9,10,39,42,-3,42
2798377,28/01/24,Wolverhampton,30,7,6,13,9,8,32,28,4,48
2798377,28/01/24,Watford,30,3,6,9,7,14,28,38,-10,34
2798377,28/01/24,London Guns,30,9,6,15,8,7,66,41,25,53
2798377,28/01/24,Everton,30,6,5,11,7,12,42,40,2,40
2798377,28/01/24,Burnley,30,4,1,5,13,12,19,34,-15,28
2798377,28/01/24,Southampton,30,4,3,7,7,16,23,40,-17,28
2798377,28/01/24,Leicester,30,5,4,9,4,17,32,55,-23,31
2798377,28/01/24,Crystal Palace,30,5,1,6,8,16,28,49,-21,26
2798377,28/01/24,Newcastle,30,2,5,7,8,15,34,55,-21,29
2798407,29/01/24,Chelsea,30,11,9,20,6,4,53,21,32,66
2798407,29/01/24,Liverpool,30,11,9,20,4,6,57,33,24,64
2798407,29/01/24,Tottenham,30,9,7,16,4,10,41,35,6,52
2798407,29/01/24,Manchester Blue,30,11,5,16,4,10,58,39,19,52
2798407,29/01/24,Bournemouth,30,9,7,16,6,8,43,29,14,54
2798407,29/01/24,West Ham,30,4,1,5,5,20,15,52,-37,20
2798407,29/01/24,Manchester Reds,30,7,8,15,6,9,44,26,18,51
2798407,29/01/24,Wolverhampton,30,6,2,8,5,17,17,38,-21,29
2798407,29/01/24,Watford,30,5,2,7,9,14,30,35,-5,30
2798407,29/01/24,London Guns,30,6,8,14,8,8,48,35,13,50
2798407,29/01/24,Everton,30,7,4,11,6,13,38,41,-3,39
2798407,29/01/24,Burnley,30,4,2,6,9,15,34,48,-14,27
2798407,29/01/24,Southampton,30,5,2,7,3,20,22,59,-37,24
2798407,29/01/24,Leicester,30,9,7,16,5,9,53,39,14,53
2798407,29/01/24,Crystal Palace,30,4,3,7,5,18,30,44,-14,26
2798407,29/01/24,Newcastle,30,6,4,10,7,13,34,43,-9,37
2798431,29/01/24,Chelsea,30,5,10,15,9,6,46,29,17,54
2798431,29/01/24,Liverpool,30,8,9,17,7,6,49,27,22,58
2798431,29/01/24,Tottenham,30,6,4,10,8,12,39,36,3,38
2798431,29/01/24,Manchester Blue,30,8,7,15,7,8,59,35,24,52
2798431,29/01/24,Bournemouth,30,8,6,14,8,8,37,28,9,50
2798431,29/01/24,West Ham,30,6,6,12,6,12,33,44,-11,42
2798431,29/01/24,Manchester Reds,30,2,6,8,12,10,31,34,-3,36
2798431,29/01/24,Wolverhampton,30,5,8,13,8,9,34,31,3,47
2798431,29/01/24,Watford,30,6,3,9,6,15,32,36,-4,33
2798431,29/01/24,London Guns,30,11,7,18,6,6,63,33,30,60
2798431,29/01/24,Everton,30,9,5,14,3,13,50,49,1,45
2798431,29/01/24,Burnley,30,5,2,7,11,12,26,45,-19,32
2798431,29/01/24,Southampton,30,6,1,7,6,17,23,38,-15,27
2798431,29/01/24,Leicester,30,6,4,10,7,13,37,52,-15,37
2798431,29/01/24,Crystal Palace,30,4,3,7,7,16,30,51,-21,28
2798431,29/01/24,Newcastle,30,4,2,6,5,19,27,48,-21,23
2798458,29/01/24,Chelsea,30,8,10,18,8,4,57,21,36,62
2798458,29/01/24,Liverpool,30,8,7,15,13,2,50,21,29,58
2798458,29/01/24,Tottenham,30,9,9,18,7,5,54,23,31,61
2798458,29/01/24,Manchester Blue,30,9,7,16,6,8,61,45,16,54
2798458,29/01/24,Bournemouth,30,7,6,13,9,8,37,29,8,48
2798458,29/01/24,West Ham,30,7,3,10,11,9,39,37,2,41
2798458,29/01/24,Manchester Reds,30,7,5,12,10,8,53,40,13,46
2798458,29/01/24,Wolverhampton,30,4,9,13,11,6,32,27,5,50
2798458,29/01/24,Watford,30,2,3,5,12,13,34,48,-14,27
2798458,29/01/24,London Guns,30,6,6,12,8,10,41,38,3,44
2798458,29/01/24,Everton,30,4,6,10,11,9,43,43,0,41
2798458,29/01/24,Burnley,30,4,2,6,5,19,25,53,-28,23
2798458,29/01/24,Southampton,30,0,3,3,9,18,20,51,-31,18
2798458,29/01/24,Leicester,30,5,5,10,7,13,44,51,-7,37
2798458,29/01/24,Crystal Palace,30,4,1,5,6,19,25,50,-25,21
2798458,29/01/24,Newcastle,30,4,0,4,7,19,22,60,-38,19
2798481,29/01/24,Chelsea,30,10,5,15,8,7,46,29,17,53
2798481,29/01/24,Liverpool,30,8,9,17,7,6,52,27,25,58
2798481,29/01/24,Tottenham,30,11,5,16,6,8,64,33,31,54
2798481,29/01/24,Manchester Blue,30,9,8,17,7,6,57,32,25,58
2798481,29/01/24,Bournemouth,30,12,7,19,2,9,47,33,14,59
2798481,29/01/24,West Ham,30,2,1,3,9,18,20,55,-35,18
2798481,29/01/24,Manchester Reds,30,6,7,13,8,9,47,34,13,47
2798481,29/01/24,Wolverhampton,30,8,2,10,9,11,28,35,-7,39
2798481,29/01/24,Watford,30,7,2,9,9,12,39,40,-1,36
2798481,29/01/24,London Guns,30,13,6,19,6,5,56,29,27,63
2798481,29/01/24,Everton,30,6,4,10,10,10,41,38,3,40
2798481,29/01/24,Burnley,30,5,6,11,6,13,31,38,-7,39
2798481,29/01/24,Southampton,30,2,3,5,8,17,20,44,-24,23
2798481,29/01/24,Leicester,30,6,4,10,2,18,30,56,-26,32
2798481,29/01/24,Crystal Palace,30,5,1,6,8,16,41,62,-21,26
2798481,29/01/24,Newcastle,30,3,2,5,5,20,19,53,-34,20
2798508,29/01/24,Chelsea,30,9,10,19,6,5,49,18,31,63
2798508,29/01/24,Liverpool,30,6,12,18,6,6,53,25,28,60
2798508,29/01/24,Tottenham,30,6,6,12,11,7,44,28,16,47
2798508,29/01/24,Manchester Blue,30,10,7,17,6,7,58,35,23,57
2798508,29/01/24,Bournemouth,30,9,9,18,3,9,41,25,16,57
2798508,29/01/24,West Ham,30,5,5,10,8,12,32,37,-5,38
2798508,29/01/24,Manchester Reds,30,5,5,10,5,15,38,44,-6,35
2798508,29/01/24,Wolverhampton,30,10,3,13,9,8,34,29,5,48
2798508,29/01/24,Watford,30,4,1,5,8,17,22,46,-24,23
2798508,29/01/24,London Guns,30,8,8,16,5,9,45,31,14,53
2798508,29/01/24,Everton,30,6,7,13,5,12,48,39,9,44
2798508,29/01/24,Burnley,30,7,3,10,7,13,35,44,-9,37
2798508,29/01/24,Southampton,30,2,4,6,7,17,26,51,-25,25
2798508,29/01/24,Leicester,30,2,2,4,8,18,20,48,-28,20
2798508,29/01/24,Crystal Palace,30,5,4,9,4,17,30,56,-26,31
2798508,29/01/24,Newcastle,30,4,4,8,6,16,30,49,-19,30
2798532,29/01/24,Chelsea,30,9,9,18,4,8,53,27,26,58
2798532,29/01/24,Liverpool,30,10,9,19,6,5,47,18,29,63
2798532,29/01/24,Tottenham,30,8,6,14,5,11,49,42,7,47
2798532,29/01/24,Manchester Blue,30,9,6,15,9,6,55,32,23,54
2798532,29/01/24,Bournemouth,30,5,5,10,9,11,28,34,-6,39
2798532,29/01/24,West Ham,30,3,4,7,7,16,29,49,-20,28
2798532,29/01/24,Manchester Reds,30,4,5,9,8,13,34,33,1,35
2798532,29/01/24,Wolverhampton,30,4,3,7,8,15,19,34,-15,29
2798532,29/01/24,Watford,30,10,5,15,6,9,37,30,7,51
2798532,29/01/24,London Guns,30,10,11,21,2,7,53,30,23,65
2798532,29/01/24,Everton,30,8,3,11,7,12,38,40,-2,40
2798532,29/01/24,Burnley,30,4,4,8,10,12,24,29,-5,34
2798532,29/01/24,Southampton,30,6,0,6,7,17,17,38,-21,25
2798532,29/01/24,Leicester,30,7,8,15,2,13,44,49,-5,47
2798532,29/01/24,Crystal Palace,30,6,3,9,8,13,28,37,-9,35
2798532,29/01/24,Newcastle,30,1,2,3,8,19,17,50,-33,17
2798557,29/01/24,Chelsea,30,9,5,14,7,9,44,34,10,49
2798557,29/01/24,Liverpool,30,12,8,20,5,5,59,34,25,65
2798557,29/01/24,Tottenham,30,8,5,13,5,12,42,32,10,44
2798557,29/01/24,Manchester Blue,30,8,8,16,6,8,51,37,14,54
2798557,29/01/24,Bournemouth,30,13,4,17,6,7,44,30,14,57
2798557,29/01/24,West Ham,30,5,5,10,6,14,33,41,-8,36
2798557,29/01/24,Manchester Reds,30,6,9,15,7,8,48,32,16,52
2798557,29/01/24,Wolverhampton,30,7,5,12,7,11,30,32,-2,43
2798557,29/01/24,Watford,30,4,2,6,12,12,35,46,-11,30
2798557,29/01/24,London Guns,30,6,6,12,8,10,38,31,7,44
2798557,29/01/24,Everton,30,4,4,8,9,13,43,52,-9,33
2798557,29/01/24,Burnley,30,3,3,6,9,15,21,37,-16,27
2798557,29/01/24,Southampton,30,4,0,4,10,16,23,47,-24,22
2798557,29/01/24,Leicester,30,6,5,11,7,12,48,40,8,40
2798557,29/01/24,Crystal Palace,30,5,4,9,7,14,35,49,-14,34
2798557,29/01/24,Newcastle,30,4,2,6,11,13,32,52,-20,29
2798588,29/01/24,Chelsea,30,13,8,21,4,5,46,19,27,67
2798588,29/01/24,Liverpool,30,12,8,20,2,8,62,30,32,62
2798588,29/01/24,Tottenham,30,6,7,13,9,8,53,37,16,48
2798588,29/01/24,Manchester Blue,30,11,6,17,8,5,54,25,29,59
2798588,29/01/24,Bournemouth,30,6,7,13,12,5,45,33,12,51
2798588,29/01/24,West Ham,30,3,2,5,10,15,28,46,-18,25
2798588,29/01/24,Manchester Reds,30,9,4,13,9,8,42,29,13,48
2798588,29/01/24,Wolverhampton,30,3,2,5,9,16,28,45,-17,24
2798588,29/01/24,Watford,30,9,5,14,4,12,38,33,5,46
2798588,29/01/24,London Guns,30,7,8,15,7,8,50,43,7,52
2798588,29/01/24,Everton,30,3,4,7,7,16,41,54,-13,28
2798588,29/01/24,Burnley,30,5,5,10,7,13,28,43,-15,37
2798588,29/01/24,Southampton,30,6,3,9,4,17,29,44,-15,31
2798588,29/01/24,Leicester,30,7,2,9,8,13,37,55,-18,35
2798588,29/01/24,Crystal Palace,30,2,3,5,5,20,35,60,-25,20
2798588,29/01/24,Newcastle,30,5,3,8,7,15,27,47,-20,31
2798615,29/01/24,Chelsea,30,10,4,14,7,9,52,33,19,49
2798615,29/01/24,Liverpool,30,8,7,15,11,4,52,36,16,56
2798615,29/01/24,Tottenham,30,8,4,12,5,13,49,50,-1,41
2798615,29/01/24,Manchester Blue,30,9,5,14,7,9,56,39,17,49
2798615,29/01/24,Bournemouth,30,7,7,14,10,6,46,35,11,52
2798615,29/01/24,West Ham,30,7,3,10,10,10,31,37,-6,40
2798615,29/01/24,Manchester Reds,30,10,4,14,5,11,55,48,7,47
2798615,29/01/24,Wolverhampton,30,7,6,13,7,10,36,27,9,46
2798615,29/01/24,Watford,30,7,3,10,8,12,24,41,-17,38
2798615,29/01/24,London Guns,30,9,7,16,4,10,60,35,25,52
2798615,29/01/24,Everton,30,8,3,11,9,10,46,46,0,42
2798615,29/01/24,Burnley,30,5,2,7,11,12,26,38,-12,32
2798615,29/01/24,Southampton,30,4,2,6,7,17,26,50,-24,25
2798615,29/01/24,Leicester,30,6,7,13,6,11,44,45,-1,45
2798615,29/01/24,Crystal Palace,30,4,2,6,7,17,25,45,-20,25
2798615,29/01/24,Newcastle,30,2,2,4,8,18,21,44,-23,20
2798638,29/01/24,Chelsea,30,9,5,14,8,8,43,23,20,50
2798638,29/01/24,Liverpool,30,10,8,18,6,6,47,19,28,60
2798638,29/01/24,Tottenham,30,10,8,18,3,9,54,41,13,57
2798638,29/01/24,Manchester Blue,30,11,9,20,5,5,55,25,30,65
2798638,29/01/24,Bournemouth,30,7,10,17,5,8,43,23,20,56
2798638,29/01/24,West Ham,30,4,2,6,8,16,24,42,-18,26
2798638,29/01/24,Manchester Reds,30,9,9,18,4,8,56,30,26,58
2798638,29/01/24,Wolverhampton,30,11,4,15,3,12,36,35,1,48
2798638,29/01/24,Watford,30,4,1,5,12,13,30,47,-17,27
2798638,29/01/24,London Guns,30,9,7,16,5,9,41,28,13,53
2798638,29/01/24,Everton,30,5,2,7,7,16,30,49,-19,28
2798638,29/01/24,Burnley,30,2,5,7,13,10,25,32,-7,34
2798638,29/01/24,Southampton,30,4,2,6,2,22,22,60,-38,20
2798638,29/01/24,Leicester,30,4,3,7,10,13,46,48,-2,31
2798638,29/01/24,Crystal Palace,30,7,3,10,4,16,32,48,-16,34
2798638,29/01/24,Newcastle,30,1,4,5,7,18,24,58,-34,22
2798664,29/01/24,Chelsea,30,7,7,14,8,8,53,36,17,50
2798664,29/01/24,Liverpool,30,5,10,15,6,9,49,37,12,51
2798664,29/01/24,Tottenham,30,5,6,11,9,10,42,37,5,42
2798664,29/01/24,Manchester Blue,30,8,7,15,6,9,54,35,19,51
2798664,29/01/24,Bournemouth,30,7,6,13,8,9,40,31,9,47
2798664,29/01/24,West Ham,30,6,2,8,5,17,26,47,-21,29
2798664,29/01/24,Manchester Reds,30,9,7,16,8,6,46,31,15,56
2798664,29/01/24,Wolverhampton,30,8,6,14,7,9,36,29,7,49
2798664,29/01/24,Watford,30,6,5,11,12,7,26,27,-1,45
2798664,29/01/24,London Guns,30,10,6,16,6,8,55,33,22,54
2798664,29/01/24,Everton,30,7,4,11,3,16,35,46,-11,36
2798664,29/01/24,Burnley,30,4,5,9,5,16,32,44,-12,32
2798664,29/01/24,Southampton,30,3,2,5,9,16,19,42,-23,24
2798664,29/01/24,Leicester,30,9,1,10,4,16,35,42,-7,34
2798664,29/01/24,Crystal Palace,30,3,8,11,6,13,27,35,-8,39
2798664,29/01/24,Newcastle,30,2,3,5,10,15,25,48,-23,25
2798690,29/01/24,Chelsea,30,7,6,13,9,8,36,28,8,48
2798690,29/01/24,Liverpool,30,9,11,20,4,6,48,26,22,64
2798690,29/01/24,Tottenham,30,11,5,16,6,8,48,32,16,54
2798690,29/01/24,Manchester Blue,30,12,8,20,3,7,61,32,29,63
2798690,29/01/24,Bournemouth,30,8,7,15,6,9,45,22,23,51
2798690,29/01/24,West Ham,30,4,4,8,9,13,34,41,-7,33
2798690,29/01/24,Manchester Reds,30,9,6,15,6,9,48,36,12,51
2798690,29/01/24,Wolverhampton,30,4,5,9,6,15,28,36,-8,33
2798690,29/01/24,Watford,30,8,3,11,7,12,30,41,-11,40
2798690,29/01/24,London Guns,30,11,4,15,6,9,44,41,3,51
2798690,29/01/24,Everton,30,5,4,9,8,13,37,42,-5,35
2798690,29/01/24,Burnley,30,4,4,8,10,12,20,35,-15,34
2798690,29/01/24,Southampton,30,3,1,4,10,16,23,44,-21,22
2798690,29/01/24,Leicester,30,8,5,13,3,14,53,48,5,42
2798690,29/01/24,Crystal Palace,30,4,4,8,2,20,27,55,-28,26
2798690,29/01/24,Newcastle,30,3,3,6,5,19,22,45,-23,23
2798713,30/01/24,Chelsea,30,9,9,18,7,5,47,25,22,61
2798713,30/01/24,Liverpool,30,6,8,14,9,7,54,41,13,51
2798713,30/01/24,Tottenham,30,6,8,14,4,12,49,43,6,46
2798713,30/01/24,Manchester Blue,30,9,7,16,6,8,61,37,24,54
2798713,30/01/24,Bournemouth,30,10,7,17,4,9,54,31,23,55
2798713,30/01/24,West Ham,30,5,4,9,3,18,38,62,-24,30
2798713,30/01/24,Manchester Reds,30,7,6,13,6,11,41,34,7,45
2798713,30/01/24,Wolverhampton,30,5,2,7,9,14,22,35,-13,30
2798713,30/01/24,Watford,30,9,4,13,3,14,40,48,-8,42
2798713,30/01/24,London Guns,30,11,11,22,5,3,62,25,37,71
2798713,30/01/24,Everton,30,10,9,19,2,9,54,34,20,59
2798713,30/01/24,Burnley,30,3,4,7,6,17,26,44,-18,27
2798713,30/01/24,Southampton,30,3,4,7,5,18,23,48,-25,26
2798713,30/01/24,Leicester,30,4,5,9,7,14,42,52,-10,34
2798713,30/01/24,Crystal Palace,30,3,4,7,5,18,28,50,-22,26
2798713,30/01/24,Newcastle,30,3,2,5,5,20,18,50,-32,20
2798742,30/01/24,Chelsea,30,12,6,18,7,5,50,20,30,61
2798742,30/01/24,Liverpool,30,8,3,11,8,11,41,32,9,41
2798742,30/01/24,Tottenham,30,10,7,17,7,6,49,26,23,58
2798742,30/01/24,Manchester Blue,30,10,10,20,6,4,60,32,28,66
2798742,30/01/24,Bournemouth,30,6,7,13,11,6,41,27,14,50
2798742,30/01/24,West Ham,30,6,1,7,7,16,31,52,-21,28
2798742,30/01/24,Manchester Reds,30,7,2,9,9,12,39,42,-3,36
2798742,30/01/24,Wolverhampton,30,5,3,8,6,16,39,49,-10,30
2798742,30/01/24,Watford,30,6,6,12,9,9,38,41,-3,45
2798742,30/01/24,London Guns,30,10,6,16,9,5,47,27,20,57
2798742,30/01/24,Everton,30,5,4,9,10,11,35,46,-11,37
2798742,30/01/24,Burnley,30,3,5,8,8,14,28,39,-11,32
2798742,30/01/24,Southampton,30,4,3,7,6,17,22,40,-18,27
2798742,30/01/24,Leicester,30,7,3,10,6,14,42,54,-12,36
2798742,30/01/24,Crystal Palace,30,4,3,7,10,13,28,43,-15,31
2798742,30/01/24,Newcastle,30,2,4,6,5,19,25,45,-20,23
2798768,30/01/24,Chelsea,30,8,6,14,7,9,44,26,18,49
2798768,30/01/24,Liverpool,30,10,8,18,7,5,50,26,24,61
2798768,30/01/24,Tottenham,30,10,7,17,5,8,52,35,17,56
2798768,30/01/24,Manchester Blue,30,11,7,18,6,6,55,24,31,60
2798768,30/01/24,Bournemouth,30,7,2,9,9,12,38,42,-4,36
2798768,30/01/24,West Ham,30,6,4,10,7,13,37,46,-9,37
2798768,30/01/24,Manchester Reds,30,14,7,21,5,4,62,24,38,68
2798768,30/01/24,Wolverhampton,30,9,3,12,7,11,41,39,2,43
2798768,30/01/24,Watford,30,5,3,8,9,13,29,37,-8,33
2798768,30/01/24,London Guns,30,11,5,16,5,9,49,33,16,53
2798768,30/01/24,Everton,30,7,5,12,7,11,37,45,-8,43
2798768,30/01/24,Burnley,30,3,6,9,5,16,28,38,-10,32
2798768,30/01/24,Southampton,30,2,3,5,7,18,23,51,-28,22
2798768,30/01/24,Leicester,30,4,2,6,8,16,31,55,-24,26
2798768,30/01/24,Crystal Palace,30,7,2,9,3,18,33,50,-17,30
2798768,30/01/24,Newcastle,30,0,2,2,11,17,21,59,-38,17
2798794,30/01/24,Chelsea,30,11,6,17,6,7,41,27,14,57
2798794,30/01/24,Liverpool,30,10,8,18,8,4,47,26,21,62
2798794,30/01/24,Tottenham,30,6,5,11,8,11,39,37,2,41
2798794,30/01/24,Manchester Blue,30,10,7,17,5,8,59,34,25,56
2798794,30/01/24,Bournemouth,30,7,7,14,9,7,37,29,8,51
2798794,30/01/24,West Ham,30,4,0,4,11,15,26,50,-24,23
2798794,30/01/24,Manchester Reds,30,9,4,13,8,9,45,31,14,47
2798794,30/01/24,Wolverhampton,30,9,6,15,5,10,35,29,6,50
2798794,30/01/24,Watford,30,5,5,10,5,15,37,48,-11,35
2798794,30/01/24,London Guns,30,13,7,20,5,5,60,25,35,65
2798794,30/01/24,Everton,30,7,1,8,9,13,30,41,-11,33
2798794,30/01/24,Burnley,30,2,5,7,8,15,17,34,-17,29
2798794,30/01/24,Southampton,30,5,3,8,9,13,24,42,-18,33
2798794,30/01/24,Leicester,30,7,0,7,7,16,33,44,-11,28
2798794,30/01/24,Crystal Palace,30,3,2,5,8,17,35,51,-16,23
2798794,30/01/24,Newcastle,30,4,2,6,9,15,27,44,-17,27
2798818,30/01/24,Chelsea,30,7,7,14,8,8,56,35,21,50
2798818,30/01/24,Liverpool,30,7,6,13,11,6,39,20,19,50
2798818,30/01/24,Tottenham,30,9,6,15,7,8,55,38,17,52
2798818,30/01/24,Manchester Blue,30,9,11,20,3,7,67,35,32,63
2798818,30/01/24,Bournemouth,30,9,5,14,12,4,49,30,19,54
2798818,30/01/24,West Ham,30,6,3,9,6,15,37,58,-21,33
2798818,30/01/24,Manchester Reds,30,9,5,14,9,7,41,23,18,51
2798818,30/01/24,Wolverhampton,30,6,2,8,9,13,28,38,-10,33
2798818,30/01/24,Watford,30,7,4,11,7,12,43,43,0,40
2798818,30/01/24,London Guns,30,12,4,16,6,8,46,36,10,54
2798818,30/01/24,Everton,30,7,5,12,11,7,46,40,6,47
2798818,30/01/24,Burnley,30,6,3,9,5,16,24,44,-20,32
2798818,30/01/24,Southampton,30,3,0,3,9,18,17,45,-28,18
2798818,30/01/24,Leicester,30,8,2,10,4,16,42,47,-5,34
2798818,30/01/24,Crystal Palace,30,2,1,3,7,20,20,62,-42,16
2798818,30/01/24,Newcastle,30,5,2,7,10,13,28,44,-16,31
2798843,30/01/24,Chelsea,30,6,5,11,10,9,40,36,4,43
2798843,30/01/24,Liverpool,30,10,8,18,3,9,50,30,20,57
2798843,30/01/24,Tottenham,30,9,6,15,7,8,52,37,15,52
2798843,30/01/24,Manchester Blue,30,11,6,17,4,9,60,33,27,55
2798843,30/01/24,Bournemouth,30,9,6,15,6,9,48,30,18,51
2798843,30/01/24,West Ham,30,2,4,6,5,19,29,53,-24,23
2798843,30/01/24,Manchester Reds,30,9,5,14,8,8,36,27,9,50
2798843,30/01/24,Wolverhampton,30,7,4,11,9,10,34,33,1,42
2798843,30/01/24,Watford,30,8,3,11,9,10,34,40,-6,42
2798843,30/01/24,London Guns,30,9,8,17,6,7,56,36,20,57
2798843,30/01/24,Everton,30,8,6,14,5,11,40,34,6,47
2798843,30/01/24,Burnley,30,5,4,9,7,14,27,38,-11,34
2798843,30/01/24,Southampton,30,4,2,6,9,15,22,42,-20,27
2798843,30/01/24,Leicester,30,7,5,12,5,13,40,42,-2,41
2798843,30/01/24,Crystal Palace,30,3,2,5,5,20,25,56,-31,20
2798843,30/01/24,Newcastle,30,4,3,7,6,17,23,49,-26,27
2798868,30/01/24,Chelsea,30,12,5,17,5,8,52,32,20,56
2798868,30/01/24,Liverpool,30,11,6,17,6,7,44,24,20,57
2798868,30/01/24,Tottenham,30,4,4,8,10,12,38,44,-6,34
2798868,30/01/24,Manchester Blue,30,10,6,16,4,10,53,39,14,52
2798868,30/01/24,Bournemouth,30,9,10,19,5,6,48,27,21,62
2798868,30/01/24,West Ham,30,3,0,3,11,16,23,44,-21,20
2798868,30/01/24,Manchester Reds,30,11,7,18,5,7,60,34,26,59
2798868,30/01/24,Wolverhampton,30,6,1,7,13,10,31,34,-3,34
2798868,30/01/24,Watford,30,7,1,8,8,14,32,53,-21,32
2798868,30/01/24,London Guns,30,11,4,15,7,8,50,36,14,52
2798868,30/01/24,Everton,30,10,7,17,5,8,54,42,12,56
2798868,30/01/24,Burnley,30,5,3,8,8,14,29,42,-13,32
2798868,30/01/24,Southampton,30,5,2,7,5,18,26,43,-17,26
2798868,30/01/24,Leicester,30,5,3,8,7,15,34,40,-6,31
2798868,30/01/24,Crystal Palace,30,6,3,9,8,13,34,44,-10,35
2798868,30/01/24,Newcastle,30,4,2,6,7,17,23,53,-30,25
2798893,30/01/24,Chelsea,30,11,7,18,4,8,48,25,23,58
2798893,30/01/24,Liverpool,30,8,8,16,7,7,63,41,22,55
2798893,30/01/24,Tottenham,30,7,6,13,9,8,47,35,12,48
2798893,30/01/24,Manchester Blue,30,10,6,16,8,6,64,35,29,56
2798893,30/01/24,Bournemouth,30,6,5,11,10,9,37,33,4,43
2798893,30/01/24,West Ham,30,9,2,11,6,13,37,48,-11,39
2798893,30/01/24,Manchester Reds,30,6,7,13,7,10,36,29,7,46
2798893,30/01/24,Wolverhampton,30,7,4,11,9,10,38,35,3,42
2798893,30/01/24,Watford,30,8,3,11,8,11,38,45,-7,41
2798893,30/01/24,London Guns,30,7,8,15,8,7,56,36,20,53
2798893,30/01/24,Everton,30,7,3,10,8,12,46,49,-3,38
2798893,30/01/24,Burnley,30,3,4,7,8,15,22,39,-17,29
2798893,30/01/24,Southampton,30,4,4,8,5,17,27,43,-16,29
2798893,30/01/24,Leicester,30,6,5,11,9,10,33,43,-10,42
2798893,30/01/24,Crystal Palace,30,5,2,7,7,16,29,49,-20,28
2798893,30/01/24,Newcastle,30,2,0,2,7,21,21,57,-36,13
2798921,30/01/24,Chelsea,30,9,6,15,8,7,39,27,12,53
2798921,30/01/24,Liverpool,30,9,11,20,5,5,53,18,35,65
2798921,30/01/24,Tottenham,30,9,6,15,7,8,44,40,4,52
2798921,30/01/24,Manchester Blue,30,10,6,16,5,9,61,42,19,53
2798921,30/01/24,Bournemouth,30,7,5,12,9,9,44,34,10,45
2798921,30/01/24,West Ham,30,8,0,8,10,12,36,43,-7,34
2798921,30/01/24,Manchester Reds,30,7,8,15,4,11,49,36,13,49
2798921,30/01/24,Wolverhampton,30,7,3,10,7,13,27,36,-9,37
2798921,30/01/24,Watford,30,6,4,10,7,13,41,43,-2,37
2798921,30/01/24,London Guns,30,7,6,13,10,7,45,28,17,49
2798921,30/01/24,Everton,30,7,3,10,5,15,39,50,-11,35
2798921,30/01/24,Burnley,30,3,4,7,11,12,26,36,-10,32
2798921,30/01/24,Southampton,30,4,3,7,9,14,28,37,-9,30
2798921,30/01/24,Leicester,30,7,6,13,10,7,55,44,11,49
2798921,30/01/24,Crystal Palace,30,3,2,5,8,17,35,60,-25,23
2798921,30/01/24,Newcastle,30,4,0,4,5,21,19,67,-48,17
2798946,30/01/24,Chelsea,30,10,5,15,4,11,50,38,12,49
2798946,30/01/24,Liverpool,30,7,9,16,8,6,47,34,13,56
2798946,30/01/24,Tottenham,30,7,4,11,10,9,40,26,14,43
2798946,30/01/24,Manchester Blue,30,10,11,21,5,4,70,30,40,68
2798946,30/01/24,Bournemouth,30,7,5,12,14,4,46,36,10,50
2798946,30/01/24,West Ham,30,3,1,4,11,15,21,44,-23,23
2798946,30/01/24,Manchester Reds,30,6,6,12,7,11,33,32,1,43
2798946,30/01/24,Wolverhampton,30,5,1,6,11,13,30,46,-16,29
2798946,30/01/24,Watford,30,6,5,11,7,12,33,43,-10,40
2798946,30/01/24,London Guns,30,9,6,15,7,8,60,37,23,52
2798946,30/01/24,Everton,30,5,5,10,9,11,44,42,2,39
2798946,30/01/24,Burnley,30,3,5,8,11,11,24,32,-8,35
2798946,30/01/24,Southampton,30,7,0,7,8,15,23,44,-21,29
2798946,30/01/24,Leicester,30,8,3,11,8,11,44,42,2,41
2798946,30/01/24,Crystal Palace,30,6,4,10,3,17,33,51,-18,33
2798946,30/01/24,Newcastle,30,1,4,5,9,16,23,44,-21,24
2798972,30/01/24,Chelsea,30,11,5,16,7,7,44,32,12,55
2798972,30/01/24,Liverpool,30,5,4,9,10,11,42,34,8,37
2798972,30/01/24,Tottenham,30,10,8,18,6,6,51,27,24,60
2798972,30/01/24,Manchester Blue,30,11,8,19,7,4,61,28,33,64
2798972,30/01/24,Bournemouth,30,8,11,19,5,6,46,29,17,62
2798972,30/01/24,West Ham,30,3,2,5,8,17,29,52,-23,23
2798972,30/01/24,Manchester Reds,30,9,7,16,6,8,56,32,24,54
2798972,30/01/24,Wolverhampton,30,7,5,12,8,10,33,34,-1,44
2798972,30/01/24,Watford,30,6,5,11,8,11,41,40,1,41
2798972,30/01/24,London Guns,30,9,6,15,5,10,51,41,10,50
2798972,30/01/24,Everton,30,7,5,12,6,12,39,39,0,42
2798972,30/01/24,Burnley,30,3,0,3,6,21,26,57,-31,15
2798972,30/01/24,Southampton,30,3,3,6,8,16,29,48,-19,26
2798972,30/01/24,Leicester,30,4,5,9,8,13,32,43,-11,35
2798972,30/01/24,Crystal Palace,30,4,3,7,6,17,28,53,-25,27
2798972,30/01/24,Newcastle,30,4,3,7,8,15,25,44,-19,29
2798998,30/01/24,Chelsea,30,10,5,15,6,9,40,32,8,51
2798998,30/01/24,Liverpool,30,9,9,18,8,4,40,21,19,62
2798998,30/01/24,Tottenham,30,11,3,14,6,10,59,43,16,48
2798998,30/01/24,Manchester Blue,30,9,4,13,6,11,57,33,24,45
2798998,30/01/24,Bournemouth,30,9,5,14,7,9,34,25,9,49
2798998,30/01/24,West Ham,30,2,2,4,9,17,29,51,-22,21
2798998,30/01/24,Manchester Reds,30,12,5,17,6,7,51,30,21,57
2798998,30/01/24,Wolverhampton,30,7,1,8,12,10,30,28,2,36
2798998,30/01/24,Watford,30,4,4,8,8,14,29,47,-18,32
2798998,30/01/24,London Guns,30,9,6,15,10,5,49,30,19,55
2798998,30/01/24,Everton,30,7,8,15,5,10,49,41,8,50
2798998,30/01/24,Burnley,30,5,3,8,7,15,22,40,-18,31
2798998,30/01/24,Southampton,30,3,3,6,6,18,23,47,-24,24
2798998,30/01/24,Leicester,30,7,3,10,11,9,39,36,3,41
2798998,30/01/24,Crystal Palace,30,4,4,8,11,11,23,31,-8,35
2798998,30/01/24,Newcastle,30,4,1,5,6,19,27,66,-39,21
2799025,30/01/24,Chelsea,30,7,8,15,8,7,49,34,15,53
2799025,30/01/24,Liverpool,30,9,9,18,8,4,57,28,29,62
2799025,30/01/24,Tottenham,30,6,9,15,6,9,53,42,11,51
2799025,30/01/24,Manchester Blue,30,8,4,12,8,10,57,40,17,44
2799025,30/01/24,Bournemouth,30,7,10,17,7,6,48,26,22,58
2799025,30/01/24,West Ham,30,4,5,9,7,14,31,40,-9,34
2799025,30/01/24,Manchester Reds,30,5,10,15,7,8,48,32,16,52
2799025,30/01/24,Wolverhampton,30,3,4,7,8,15,30,46,-16,29
2799025,30/01/24,Watford,30,8,4,12,4,14,32,42,-10,40
2799025,30/01/24,London Guns,30,5,7,12,10,8,45,43,2,46
2799025,30/01/24,Everton,30,7,6,13,4,13,41,47,-6,43
2799025,30/01/24,Burnley,30,5,3,8,9,13,23,33,-10,33
2799025,30/01/24,Southampton,30,2,2,4,10,16,22,55,-33,22
2799025,30/01/24,Leicester,30,4,6,10,4,16,40,50,-10,34
2799025,30/01/24,Crystal Palace,30,6,3,9,6,15,41,42,-1,33
2799025,30/01/24,Newcastle,30,3,6,9,4,17,28,45,-17,31
2799047,31/01/24,Chelsea,30,9,8,17,3,10,50,34,16,54
2799047,31/01/24,Liverpool,30,9,6,15,9,6,47,26,21,54
2799047,31/01/24,Tottenham,30,11,5,16,7,7,52,31,21,55
2799047,31/01/24,Manchester Blue,30,11,7,18,6,6,58,25,33,60
2799047,31/01/24,Bournemouth,30,8,9,17,5,8,42,34,8,56
2799047,31/01/24,West Ham,30,3,4,7,11,12,34,46,-12,32
2799047,31/01/24,Manchester Reds,30,6,6,12,7,11,41,41,0,43
2799047,31/01/24,Wolverhampton,30,6,3,9,10,11,35,35,0,37
2799047,31/01/24,Watford,30,6,3,9,5,16,34,46,-12,32
2799047,31/01/24,London Guns,30,12,8,20,2,8,64,37,27,62
2799047,31/01/24,Everton,30,4,4,8,8,14,29,46,-17,32
2799047,31/01/24,Burnley,30,6,1,7,11,12,30,40,-10,32
2799047,31/01/24,Southampton,30,3,2,5,11,14,27,36,-9,26
2799047,31/01/24,Leicester,30,5,8,13,5,12,44,47,-3,44
2799047,31/01/24,Crystal Palace,30,6,1,7,4,19,29,59,-30,25
2799047,31/01/24,Newcastle,30,5,1,6,4,20,25,58,-33,22
2799076,31/01/24,Chelsea,30,9,3,12,11,7,46,33,13,47
2799076,31/01/24,Liverpool,30,8,3,11,15,4,38,24,14,48
2799076,31/01/24,Tottenham,30,8,7,15,10,5,49,35,14,55
2799076,31/01/24,Manchester Blue,30,9,11,20,6,4,62,23,39,66
2799076,31/01/24,Bournemouth,30,8,5,13,9,8,39,26,13,48
2799076,31/01/24,West Ham,30,4,6,10,5,15,22,47,-25,35
2799076,31/01/24,Manchester Reds,30,8,5,13,9,8,59,38,21,48
2799076,31/01/24,Wolverhampton,30,8,5,13,6,11,36,30,6,45
2799076,31/01/24,Watford,30,10,3,13,6,11,39,42,-3,45
2799076,31/01/24,London Guns,30,12,10,22,4,4,61,23,38,70
2799076,31/01/24,Everton,30,5,3,8,8,14,36,48,-12,32
2799076,31/01/24,Burnley,30,2,2,4,6,20,15,40,-25,18
2799076,31/01/24,Southampton,30,3,4,7,7,16,33,46,-13,28
2799076,31/01/24,Leicester,30,7,2,9,2,19,36,54,-18,29
2799076,31/01/24,Crystal Palace,30,3,2,5,6,19,26,60,-34,21
2799076,31/01/24,Newcastle,30,4,4,8,4,18,31,59,-28,28
2799100,31/01/24,Chelsea,30,5,6,11,6,13,40,36,4,39
2799100,31/01/24,Liverpool,30,11,9,20,4,6,63,29,34,64
2799100,31/01/24,Tottenham,30,10,3,13,6,11,43,32,11,45
2799100,31/01/24,Manchester Blue,30,11,7,18,7,5,53,27,26,61
2799100,31/01/24,Bournemouth,30,6,5,11,10,9,32,29,3,43
2799100,31/01/24,West Ham,30,6,5,11,3,16,29,44,-15,36
2799100,31/01/24,Manchester Reds,30,13,7,20,6,4,50,26,24,66
2799100,31/01/24,Wolverhampton,30,7,6,13,8,9,34,30,4,47
2799100,31/01/24,Watford,30,4,1,5,11,14,24,45,-21,26
2799100,31/01/24,London Guns,30,8,6,14,7,9,40,35,5,49
2799100,31/01/24,Everton,30,3,5,8,6,16,34,47,-13,30
2799100,31/01/24,Burnley,30,3,3,6,10,14,19,34,-15,28
2799100,31/01/24,Southampton,30,6,1,7,11,12,24,37,-13,32
2799100,31/01/24,Leicester,30,7,4,11,7,12,42,39,3,40
2799100,31/01/24,Crystal Palace,30,5,4,9,7,14,31,39,-8,34
2799100,31/01/24,Newcastle,30,2,3,5,7,18,25,54,-29,22
2799127,31/01/24,Chelsea,30,9,5,14,9,7,55,32,23,51
2799127,31/01/24,Liverpool,30,9,7,16,6,8,53,36,17,54
2799127,31/01/24,Tottenham,30,10,6,16,5,9,42,24,18,53
2799127,31/01/24,Manchester Blue,30,11,7,18,6,6,63,35,28,60
2799127,31/01/24,Bournemouth,30,7,4,11,8,11,43,39,4,41
2799127,31/01/24,West Ham,30,4,2,6,11,13,25,41,-16,29
2799127,31/01/24,Manchester Reds,30,8,5,13,9,8,40,31,9,48
2799127,31/01/24,Wolverhampton,30,6,6,12,7,11,30,31,-1,43
2799127,31/01/24,Watford,30,7,5,12,7,11,38,46,-8,43
2799127,31/01/24,London Guns,30,10,7,17,7,6,46,25,21,58
2799127,31/01/24,Everton,30,4,4,8,10,12,32,39,-7,34
2799127,31/01/24,Burnley,30,4,2,6,10,14,27,44,-17,28
2799127,31/01/24,Southampton,30,4,1,5,3,22,22,57,-35,18
2799127,31/01/24,Leicester,30,6,4,10,8,12,45,46,-1,38
2799127,31/01/24,Crystal Palace,30,7,5,12,5,13,41,44,-3,41
2799127,31/01/24,Newcastle,30,2,3,5,7,18,31,63,-32,22
2799149,31/01/24,Chelsea,30,11,7,18,6,6,48,23,25,60
2799149,31/01/24,Liverpool,30,12,6,18,4,8,49,29,20,58
2799149,31/01/24,Tottenham,30,9,5,14,4,12,47,42,5,46
2799149,31/01/24,Manchester Blue,30,11,8,19,6,5,48,26,22,63
2799149,31/01/24,Bournemouth,30,7,4,11,12,7,39,30,9,45
2799149,31/01/24,West Ham,30,5,1,6,9,15,31,48,-17,27
2799149,31/01/24,Manchester Reds,30,9,6,15,4,11,45,45,0,49
2799149,31/01/24,Wolverhampton,30,6,4,10,11,9,31,30,1,41
2799149,31/01/24,Watford,30,5,4,9,11,10,38,37,1,38
2799149,31/01/24,London Guns,30,7,7,14,9,7,44,29,15,51
2799149,31/01/24,Everton,30,8,2,10,8,12,33,39,-6,38
2799149,31/01/24,Burnley,30,7,1,8,10,12,23,36,-13,34
2799149,31/01/24,Southampton,30,5,2,7,6,17,23,38,-15,27
2799149,31/01/24,Leicester,30,5,4,9,7,14,44,48,-4,34
2799149,31/01/24,Crystal Palace,30,3,0,3,11,16,25,53,-28,20
2799149,31/01/24,Newcastle,30,6,1,7,6,17,31,46,-15,27
2799177,31/01/24,Chelsea,30,9,8,17,7,6,52,31,21,58
2799177,31/01/24,Liverpool,30,10,6,16,7,7,45,21,24,55
2799177,31/01/24,Tottenham,30,8,3,11,7,12,39,39,0,40
2799177,31/01/24,Manchester Blue,30,7,8,15,7,8,47,25,22,52
2799177,31/01/24,Bournemouth,30,10,8,18,6,6,46,22,24,60
2799177,31/01/24,West Ham,30,5,3,8,6,16,30,46,-16,30
2799177,31/01/24,Manchester Reds,30,10,5,15,8,7,58,40,18,53
2799177,31/01/24,Wolverhampton,30,8,2,10,8,12,40,46,-6,38
2799177,31/01/24,Watford,30,7,5,12,4,14,47,44,3,40
2799177,31/01/24,London Guns,30,5,7,12,11,7,57,43,14,47
2799177,31/01/24,Everton,30,4,5,9,8,13,32,44,-12,35
2799177,31/01/24,Burnley,30,6,4,10,4,16,27,43,-16,34
2799177,31/01/24,Southampton,30,3,1,4,9,17,24,52,-28,21
2799177,31/01/24,Leicester,30,8,5,13,5,12,44,50,-6,44
2799177,31/01/24,Crystal Palace,30,8,3,11,6,13,39,48,-9,39
2799177,31/01/24,Newcastle,30,4,0,4,7,19,27,60,-33,19
2799202,31/01/24,Chelsea,30,8,7,15,9,6,46,36,10,54
2799202,31/01/24,Liverpool,30,10,10,20,4,6,48,29,19,64
2799202,31/01/24,Tottenham,30,5,6,11,12,7,54,41,13,45
2799202,31/01/24,Manchester Blue,30,11,7,18,8,4,66,35,31,62
2799202,31/01/24,Bournemouth,30,10,8,18,5,7,49,24,25,59
2799202,31/01/24,West Ham,30,7,1,8,10,12,32,39,-7,34
2799202,31/01/24,Manchester Reds,30,6,4,10,7,13,43,39,4,37
2799202,31/01/24,Wolverhampton,30,3,1,4,12,14,24,43,-19,24
2799202,31/01/24,Watford,30,9,4,13,5,12,37,45,-8,44
2799202,31/01/24,London Guns,30,8,5,13,10,7,54,35,19,49
2799202,31/01/24,Everton,30,7,3,10,8,12,39,42,-3,38
2799202,31/01/24,Burnley,30,1,2,3,9,18,16,39,-23,18
2799202,31/01/24,Southampton,30,5,3,8,9,13,27,40,-13,33
2799202,31/01/24,Leicester,30,4,5,9,7,14,43,50,-7,34
2799202,31/01/24,Crystal Palace,30,5,3,8,8,14,31,41,-10,32
2799202,31/01/24,Newcastle,30,4,3,7,7,16,28,59,-31,28
2799231,31/01/24,Chelsea,30,10,8,18,5,7,64,28,36,59
2799231,31/01/24,Liverpool,30,12,7,19,4,7,45,23,22,61
2799231,31/01/24,Tottenham,30,8,5,13,6,11,47,41,6,45
2799231,31/01/24,Manchester Blue,30,8,7,15,6,9,56,35,21,51
2799231,31/01/24,Bournemouth,30,9,11,20,2,8,53,29,24,62
2799231,31/01/24,West Ham,30,8,1,9,2,19,26,50,-24,29
2799231,31/01/24,Manchester Reds,30,10,7,17,4,9,49,35,14,55
2799231,31/01/24,Wolverhampton,30,4,6,10,8,12,29,29,0,38
2799231,31/01/24,Watford,30,9,6,15,5,10,46,35,11,50
2799231,31/01/24,London Guns,30,11,9,20,4,6,60,30,30,64
2799231,31/01/24,Everton,30,6,4,10,7,13,38,48,-10,37
2799231,31/01/24,Burnley,30,0,1,1,4,25,10,61,-51,7
2799231,31/01/24,Southampton,30,3,2,5,6,19,27,49,-22,21
2799231,31/01/24,Leicester,30,7,6,13,4,13,54,49,5,43
2799231,31/01/24,Crystal Palace,30,5,4,9,4,17,35,62,-27,31
2799231,31/01/24,Newcastle,30,3,5,8,5,17,22,57,-35,29
2799255,31/01/24,Chelsea,30,5,8,13,9,8,43,30,13,48
2799255,31/01/24,Liverpool,30,7,5,12,10,8,45,36,9,46
2799255,31/01/24,Tottenham,30,7,7,14,6,10,42,32,10,48
2799255,31/01/24,Manchester Blue,30,10,8,18,5,7,47,32,15,59
2799255,31/01/24,Bournemouth,30,8,6,14,10,6,32,21,11,52
2799255,31/01/24,West Ham,30,1,4,5,12,13,34,48,-14,27
2799255,31/01/24,Manchester Reds,30,9,7,16,7,7,41,27,14,55
2799255,31/01/24,Wolverhampton,30,5,2,7,11,12,24,33,-9,32
2799255,31/01/24,Watford,30,7,2,9,4,17,26,40,-14,31
2799255,31/01/24,London Guns,30,12,6,18,6,6,63,29,34,60
2799255,31/01/24,Everton,30,6,5,11,7,12,39,44,-5,40
2799255,31/01/24,Burnley,30,5,5,10,6,14,25,38,-13,36
2799255,31/01/24,Southampton,30,6,4,10,6,14,34,51,-17,36
2799255,31/01/24,Leicester,30,2,5,7,12,11,32,44,-12,33
2799255,31/01/24,Crystal Palace,30,3,1,4,9,17,33,48,-15,21
2799255,31/01/24,Newcastle,30,6,2,8,8,14,28,35,-7,32
2799282,31/01/24,Chelsea,30,6,8,14,8,8,45,32,13,50
2799282,31/01/24,Liverpool,30,8,4,12,8,10,34,32,2,44
2799282,31/01/24,Tottenham,30,13,4,17,5,8,60,38,22,56
2799282,31/01/24,Manchester Blue,30,10,7,17,7,6,54,29,25,58
2799282,31/01/24,Bournemouth,30,7,3,10,9,11,34,31,3,39
2799282,31/01/24,West Ham,30,5,2,7,9,14,31,49,-18,30
2799282,31/01/24,Manchester Reds,30,7,8,15,7,8,49,39,10,52
2799282,31/01/24,Wolverhampton,30,6,3,9,8,13,32,43,-11,35
2799282,31/01/24,Watford,30,9,2,11,10,9,36,30,6,43
2799282,31/01/24,London Guns,30,12,7,19,6,5,50,24,26,63
2799282,31/01/24,Everton,30,5,3,8,8,14,34,43,-9,32
2799282,31/01/24,Burnley,30,4,1,5,9,16,22,39,-17,24
2799282,31/01/24,Southampton,30,3,1,4,11,15,24,46,-22,23
2799282,31/01/24,Leicester,30,8,5,13,5,12,38,34,4,44
2799282,31/01/24,Crystal Palace,30,4,1,5,7,18,30,60,-30,22
2799282,31/01/24,Newcastle,30,9,4,13,5,12,39,43,-4,44
2799303,31/01/24,Chelsea,30,10,12,22,4,4,58,25,33,70
2799303,31/01/24,Liverpool,30,9,9,18,5,7,55,28,27,59
2799303,31/01/24,Tottenham,30,7,9,16,5,9,41,30,11,53
2799303,31/01/24,Manchester Blue,30,10,5,15,11,4,55,29,26,56
2799303,31/01/24,Bournemouth,30,8,4,12,7,11,35,29,6,43
2799303,31/01/24,West Ham,30,3,2,5,8,17,27,46,-19,23
2799303,31/01/24,Manchester Reds,30,8,8,16,4,10,50,31,19,52
2799303,31/01/24,Wolverhampton,30,5,6,11,9,10,28,34,-6,42
2799303,31/01/24,Watford,30,5,7,12,3,15,44,52,-8,39
2799303,31/01/24,London Guns,30,9,7,16,6,8,40,28,12,54
2799303,31/01/24,Everton,30,4,2,6,7,17,31,55,-24,25
2799303,31/01/24,Burnley,30,5,2,7,7,16,23,42,-19,28
2799303,31/01/24,Southampton,30,4,4,8,5,17,24,40,-16,29
2799303,31/01/24,Leicester,30,6,4,10,8,12,35,41,-6,38
2799303,31/01/24,Crystal Palace,30,4,3,7,5,18,32,51,-19,26
2799303,31/01/24,Newcastle,30,4,5,9,6,15,30,47,-17,33
2799331,31/01/24,Chelsea,30,10,9,19,5,6,43,20,23,62
2799331,31/01/24,Liverpool,30,9,4,13,5,12,50,37,13,44
2799331,31/01/24,Tottenham,30,5,5,10,9,11,42,43,-1,39
2799331,31/01/24,Manchester Blue,30,9,8,17,9,4,54,28,26,60
2799331,31/01/24,Bournemouth,30,9,7,16,6,8,50,30,20,54
2799331,31/01/24,West Ham,30,3,2,5,7,18,32,61,-29,22
2799331,31/01/24,Manchester Reds,30,7,8,15,7,8,55,39,16,52
2799331,31/01/24,Wolverhampton,30,10,3,13,8,9,41,33,8,47
2799331,31/01/24,Watford,30,7,2,9,6,15,29,48,-19,33
2799331,31/01/24,London Guns,30,9,7,16,6,8,54,26,28,54
2799331,31/01/24,Everton,30,9,5,14,7,9,44,38,6,49
2799331,31/01/24,Burnley,30,7,6,13,6,11,35,33,2,45
2799331,31/01/24,Southampton,30,5,1,6,6,18,21,52,-31,24
2799331,31/01/24,Leicester,30,6,4,10,4,16,33,47,-14,34
2799331,31/01/24,Crystal Palace,30,3,4,7,3,20,30,54,-24,24
2799331,31/01/24,Newcastle,30,4,3,7,6,17,25,49,-24,27
2799355,31/01/24,Chelsea,30,7,6,13,5,12,42,40,2,44
2799355,31/01/24,Liverpool,30,10,7,17,4,9,55,37,18,55
2799355,31/01/24,Tottenham,30,6,5,11,10,9,44,45,-1,43
2799355,31/01/24,Manchester Blue,30,9,3,12,9,9,56,40,16,45
2799355,31/01/24,Bournemouth,30,9,9,18,4,8,40,26,14,58
2799355,31/01/24,West Ham,30,4,3,7,7,16,29,43,-14,28
2799355,31/01/24,Manchester Reds,30,11,7,18,7,5,49,26,23,61
2799355,31/01/24,Wolverhampton,30,10,4,14,5,11,45,38,7,47
2799355,31/01/24,Watford,30,9,7,16,5,9,42,26,16,53
2799355,31/01/24,London Guns,30,8,9,17,7,6,44,29,15,58
2799355,31/01/24,Everton,30,8,3,11,8,11,39,36,3,41
2799355,31/01/24,Burnley,30,4,5,9,9,12,28,34,-6,36
2799355,31/01/24,Southampton,30,3,1,4,3,23,17,52,-35,15
2799355,31/01/24,Leicester,30,6,4,10,4,16,38,48,-10,34
2799355,31/01/24,Crystal Palace,30,3,4,7,5,18,33,60,-27,26
2799355,31/01/24,Newcastle,30,4,4,8,4,18,21,42,-21,28
2799380,01/02/24,Chelsea,30,12,7,19,7,4,50,23,27,64
2799380,01/02/24,Liverpool,30,13,7,20,4,6,58,31,27,64
2799380,01/02/24,Tottenham,30,10,5,15,7,8,48,31,17,52
2799380,01/02/24,Manchester Blue,30,11,4,15,5,10,49,35,14,50
2799380,01/02/24,Bournemouth,30,4,4,8,11,11,32,37,-5,35
2799380,01/02/24,West Ham,30,2,2,4,9,17,28,50,-22,21
2799380,01/02/24,Manchester Reds,30,10,6,16,8,6,50,29,21,56
2799380,01/02/24,Wolverhampton,30,7,3,10,11,9,32,32,0,41
2799380,01/02/24,Watford,30,4,4,8,11,11,24,42,-18,35
2799380,01/02/24,London Guns,30,8,6,14,9,7,51,33,18,51
2799380,01/02/24,Everton,30,7,7,14,6,10,46,36,10,48
2799380,01/02/24,Burnley,30,6,3,9,7,14,31,37,-6,34
2799380,01/02/24,Southampton,30,3,4,7,5,18,22,44,-22,26
2799380,01/02/24,Leicester,30,4,3,7,4,19,35,66,-31,25
2799380,01/02/24,Crystal Palace,30,4,2,6,7,17,23,45,-22,25
2799380,01/02/24,Newcastle,30,5,4,9,7,14,32,40,-8,34
2799409,01/02/24,Chelsea,30,9,8,17,5,8,59,29,30,56
2799409,01/02/24,Liverpool,30,13,5,18,4,8,58,32,26,58
2799409,01/02/24,Tottenham,30,8,6,14,6,10,43,26,17,48
2799409,01/02/24,Manchester Blue,30,9,7,16,8,6,48,32,16,56
2799409,01/02/24,Bournemouth,30,5,4,9,12,9,33,26,7,39
2799409,01/02/24,West Ham,30,8,5,13,4,13,34,46,-12,43
2799409,01/02/24,Manchester Reds,30,6,6,12,9,9,41,35,6,45
2799409,01/02/24,Wolverhampton,30,6,6,12,7,11,38,38,0,43
2799409,01/02/24,Watford,30,6,4,10,6,14,45,51,-6,36
2799409,01/02/24,London Guns,30,11,6,17,4,9,54,38,16,55
2799409,01/02/24,Everton,30,4,4,8,10,12,38,47,-9,34
2799409,01/02/24,Burnley,30,2,2,4,9,17,14,41,-27,21
2799409,01/02/24,Southampton,30,5,0,5,7,18,22,56,-34,22
2799409,01/02/24,Leicester,30,6,5,11,7,12,48,48,0,40
2799409,01/02/24,Crystal Palace,30,2,6,8,9,13,29,45,-16,33
2799409,01/02/24,Newcastle,30,6,2,8,9,13,27,41,-14,33
2799438,01/02/24,Chelsea,30,10,8,18,4,8,54,25,29,58
2799438,01/02/24,Liverpool,30,11,8,19,7,4,60,27,33,64
2799438,01/02/24,Tottenham,30,7,6,13,8,9,37,32,5,47
2799438,01/02/24,Manchester Blue,30,10,8,18,7,5,54,34,20,61
2799438,01/02/24,Bournemouth,30,7,6,13,8,9,40,33,7,47
2799438,01/02/24,West Ham,30,5,4,9,7,14,30,43,-13,34
2799438,01/02/24,Manchester Reds,30,8,7,15,8,7,50,29,21,53
2799438,01/02/24,Wolverhampton,30,6,4,10,11,9,36,29,7,41
2799438,01/02/24,Watford,30,4,6,10,5,15,30,45,-15,35
2799438,01/02/24,London Guns,30,8,8,16,7,7,57,33,24,55
2799438,01/02/24,Everton,30,6,4,10,4,16,46,51,-5,34
2799438,01/02/24,Burnley,30,5,1,6,8,16,23,42,-19,26
2799438,01/02/24,Southampton,30,2,3,5,7,18,20,48,-28,22
2799438,01/02/24,Leicester,30,5,5,10,8,12,47,50,-3,38
2799438,01/02/24,Crystal Palace,30,4,1,5,11,14,24,53,-29,26
2799438,01/02/24,Newcastle,30,2,2,4,8,18,20,54,-34,20
2799462,01/02/24,Chelsea,30,7,5,12,10,8,40,32,8,46
2799462,01/02/24,Liverpool,30,6,3,9,10,11,36,34,2,37
2799462,01/02/24,Tottenham,30,11,9,20,5,5,59,30,29,65
2799462,01/02/24,Manchester Blue,30,11,7,18,6,6,61,30,31,60
2799462,01/02/24,Bournemouth,30,9,6,15,6,9,41,32,9,51
2799462,01/02/24,West Ham,30,7,4,11,4,15,29,44,-15,37
2799462,01/02/24,Manchester Reds,30,7,8,15,8,7,46,40,6,53
2799462,01/02/24,Wolverhampton,30,8,6,14,7,9,33,28,5,49
2799462,01/02/24,Watford,30,6,6,12,8,10,49,39,10,44
2799462,01/02/24,London Guns,30,9,8,17,8,5,64,26,38,59
2799462,01/02/24,Everton,30,5,5,10,7,13,42,45,-3,37
2799462,01/02/24,Burnley,30,2,1,3,11,16,18,38,-20,20
2799462,01/02/24,Southampton,30,6,3,9,7,14,29,54,-25,34
2799462,01/02/24,Leicester,30,5,5,10,7,13,35,46,-11,37
2799462,01/02/24,Crystal Palace,30,1,2,3,5,22,17,54,-37,14
2799462,01/02/24,Newcastle,30,2,1,3,9,18,24,51,-27,18
2799489,01/02/24,Chelsea,30,9,8,17,6,7,47,25,22,57
2799489,01/02/24,Liverpool,30,9,6,15,7,8,42,28,14,52
2799489,01/02/24,Tottenham,30,8,7,15,6,9,40,27,13,51
2799489,01/02/24,Manchester Blue,30,10,9,19,4,7,57,27,30,61
2799489,01/02/24,Bournemouth,30,4,5,9,10,11,32,30,2,37
2799489,01/02/24,West Ham,30,2,1,3,11,16,22,53,-31,20
2799489,01/02/24,Manchester Reds,30,7,8,15,8,7,44,29,15,53
2799489,01/02/24,Wolverhampton,30,6,4,10,8,12,23,27,-4,38
2799489,01/02/24,Watford,30,6,3,9,6,15,28,41,-13,33
2799489,01/02/24,London Guns,30,12,5,17,8,5,52,28,24,59
2799489,01/02/24,Everton,30,5,6,11,9,10,44,44,0,42
2799489,01/02/24,Burnley,30,4,4,8,10,12,24,38,-14,34
2799489,01/02/24,Southampton,30,7,3,10,5,15,31,41,-10,35
2799489,01/02/24,Leicester,30,3,3,6,5,19,27,49,-22,23
2799489,01/02/24,Crystal Palace,30,5,3,8,9,13,28,40,-12,33
2799489,01/02/24,Newcastle,30,3,4,7,10,13,26,40,-14,31
2799514,01/02/24,Chelsea,30,6,9,15,11,4,46,26,20,56
2799514,01/02/24,Liverpool,30,11,10,21,3,6,57,30,27,66
2799514,01/02/24,Tottenham,30,9,4,13,8,9,43,37,6,47
2799514,01/02/24,Manchester Blue,30,8,6,14,11,5,62,42,20,53
2799514,01/02/24,Bournemouth,30,9,7,16,6,8,47,29,18,54
2799514,01/02/24,West Ham,30,4,3,7,6,17,30,55,-25,27
2799514,01/02/24,Manchester Reds,30,5,4,9,11,10,44,40,4,38
2799514,01/02/24,Wolverhampton,30,7,5,12,12,6,42,27,15,48
2799514,01/02/24,Watford,30,4,4,8,6,16,30,47,-17,30
2799514,01/02/24,London Guns,30,11,7,18,7,5,55,29,26,61
2799514,01/02/24,Everton,30,6,5,11,7,12,35,39,-4,40
2799514,01/02/24,Burnley,30,4,4,8,4,18,24,41,-17,28
2799514,01/02/24,Southampton,30,3,4,7,9,14,26,40,-14,30
2799514,01/02/24,Leicester,30,5,4,9,10,11,41,49,-8,37
2799514,01/02/24,Crystal Palace,30,1,3,4,8,18,26,51,-25,20
2799514,01/02/24,Newcastle,30,4,2,6,5,19,26,52,-26,23
2799538,01/02/24,Chelsea,30,9,8,17,8,5,52,29,23,59
2799538,01/02/24,Liverpool,30,10,9,19,5,6,46,23,23,62
2799538,01/02/24,Tottenham,30,7,7,14,4,12,41,37,4,46
2799538,01/02/24,Manchester Blue,30,9,2,11,6,13,51,43,8,39
2799538,01/02/24,Bournemouth,30,10,3,13,9,8,36,24,12,48
2799538,01/02/24,West Ham,30,6,4,10,8,12,32,35,-3,38
2799538,01/02/24,Manchester Reds,30,6,6,12,8,10,39,33,6,44
2799538,01/02/24,Wolverhampton,30,7,3,10,5,15,31,41,-10,35
2799538,01/02/24,Watford,30,6,1,7,6,17,31,46,-15,27
2799538,01/02/24,London Guns,30,8,7,15,3,12,46,36,10,48
2799538,01/02/24,Everton,30,4,6,10,8,12,41,46,-5,38
2799538,01/02/24,Burnley,30,4,4,8,14,8,30,25,5,38
2799538,01/02/24,Southampton,30,7,3,10,5,15,30,43,-13,35
2799538,01/02/24,Leicester,30,6,5,11,5,14,32,54,-22,38
2799538,01/02/24,Crystal Palace,30,6,4,10,9,11,42,52,-10,39
2799538,01/02/24,Newcastle,30,5,3,8,7,15,28,41,-13,31
2799569,01/02/24,Chelsea,30,6,8,14,7,9,53,37,16,49
2799569,01/02/24,Liverpool,30,10,6,16,7,7,44,29,15,55
2799569,01/02/24,Tottenham,30,11,4,15,6,9,47,37,10,51
2799569,01/02/24,Manchester Blue,30,12,8,20,6,4,64,18,46,66
2799569,01/02/24,Bournemouth,30,6,3,9,11,10,27,37,-10,38
2799569,01/02/24,West Ham,30,7,0,7,10,13,30,39,-9,31
2799569,01/02/24,Manchester Reds,30,6,7,13,8,9,39,32,7,47
2799569,01/02/24,Wolverhampton,30,5,1,6,9,15,25,41,-16,27
2799569,01/02/24,Watford,30,5,9,14,7,9,42,32,10,49
2799569,01/02/24,London Guns,30,9,8,17,9,4,52,30,22,60
2799569,01/02/24,Everton,30,6,3,9,5,16,50,52,-2,32
2799569,01/02/24,Burnley,30,2,4,6,13,11,26,35,-9,31
2799569,01/02/24,Southampton,30,4,0,4,7,19,20,50,-30,19
2799569,01/02/24,Leicester,30,8,4,12,5,13,42,43,-1,41
2799569,01/02/24,Crystal Palace,30,7,3,10,6,14,33,54,-21,36
2799569,01/02/24,Newcastle,30,3,1,4,12,14,26,54,-28,24
2799592,01/02/24,Chelsea,30,10,11,21,3,6,47,25,22,66
2799592,01/02/24,Liverpool,30,8,6,14,8,8,46,38,8,50
2799592,01/02/24,Tottenham,30,7,8,15,6,9,51,39,12,51
2799592,01/02/24,Manchester Blue,30,10,8,18,7,5,63,35,28,61
2799592,01/02/24,Bournemouth,30,9,4,13,5,12,49,41,8,44
2799592,01/02/24,West Ham,30,4,3,7,8,15,27,44,-17,29
2799592,01/02/24,Manchester Reds,30,9,4,13,7,10,44,29,15,46
2799592,01/02/24,Wolverhampton,30,5,3,8,11,11,27,30,-3,35
2799592,01/02/24,Watford,30,5,6,11,9,10,34,40,-6,42
2799592,01/02/24,London Guns,30,9,7,16,7,7,57,28,29,55
2799592,01/02/24,Everton,30,6,2,8,9,13,37,48,-11,33
2799592,01/02/24,Burnley,30,5,2,7,7,16,25,45,-20,28
2799592,01/02/24,Southampton,30,7,2,9,9,12,27,35,-8,36
2799592,01/02/24,Leicester,30,7,2,9,6,15,37,49,-12,33
2799592,01/02/24,Crystal Palace,30,7,3,10,7,13,33,42,-9,37
2799592,01/02/24,Newcastle,30,2,1,3,7,20,24,60,-36,16
2799621,01/02/24,Chelsea,30,11,9,20,3,7,51,26,25,63
2799621,01/02/24,Liverpool,30,12,5,17,6,7,54,36,18,57
2799621,01/02/24,Tottenham,30,6,5,11,7,12,43,33,10,40
2799621,01/02/24,Manchester Blue,30,10,10,20,4,6,68,33,35,64
2799621,01/02/24,Bournemouth,30,9,5,14,7,9,40,30,10,49
2799621,01/02/24,West Ham,30,5,3,8,5,17,28,53,-25,29
2799621,01/02/24,Manchester Reds,30,7,5,12,7,11,32,35,-3,43
2799621,01/02/24,Wolverhampton,30,7,4,11,10,9,34,25,9,43
2799621,01/02/24,Watford,30,3,5,8,9,13,29,32,-3,33
2799621,01/02/24,London Guns,30,13,6,19,2,9,51,30,21,59
2799621,01/02/24,Everton,30,9,4,13,11,6,49,36,13,50
2799621,01/02/24,Burnley,30,5,3,8,6,16,27,40,-13,30
2799621,01/02/24,Southampton,30,3,0,3,7,20,12,46,-34,16
2799621,01/02/24,Leicester,30,8,3,11,5,14,34,38,-4,38
2799621,01/02/24,Crystal Palace,30,4,4,8,5,17,24,49,-25,29
2799621,01/02/24,Newcastle,30,3,4,7,6,17,25,59,-34,27
2799644,01/02/24,Chelsea,30,7,9,16,5,9,46,29,17,53
2799644,01/02/24,Liverpool,30,9,6,15,12,3,47,27,20,57
2799644,01/02/24,Tottenham,30,10,7,17,6,7,54,32,22,57
2799644,01/02/24,Manchester Blue,30,6,3,9,12,9,47,41,6,39
2799644,01/02/24,Bournemouth,30,10,6,16,7,7,43,27,16,55
2799644,01/02/24,West Ham,30,3,5,8,9,13,35,44,-9,33
2799644,01/02/24,Manchester Reds,30,7,5,12,8,10,49,42,7,44
2799644,01/02/24,Wolverhampton,30,7,3,10,11,9,29,30,-1,41
2799644,01/02/24,Watford,30,5,8,13,8,9,37,34,3,47
2799644,01/02/24,London Guns,30,9,6,15,6,9,68,44,24,51
2799644,01/02/24,Everton,30,6,5,11,6,13,40,43,-3,39
2799644,01/02/24,Burnley,30,6,4,10,7,13,25,34,-9,37
2799644,01/02/24,Southampton,30,4,3,7,8,15,30,48,-18,29
2799644,01/02/24,Leicester,30,5,2,7,5,18,36,58,-22,26
2799644,01/02/24,Crystal Palace,30,5,3,8,5,17,27,50,-23,29
2799644,01/02/24,Newcastle,30,4,0,4,9,17,22,52,-30,21
2799671,01/02/24,Chelsea,30,8,5,13,7,10,44,35,9,46
2799671,01/02/24,Liverpool,30,9,6,15,9,6,40,27,13,54
2799671,01/02/24,Tottenham,30,9,4,13,8,9,44,41,3,47
2799671,01/02/24,Manchester Blue,30,7,8,15,7,8,57,33,24,52
2799671,01/02/24,Bournemouth,30,5,6,11,9,10,41,38,3,42
2799671,01/02/24,West Ham,30,4,6,10,11,9,32,37,-5,41
2799671,01/02/24,Manchester Reds,30,10,5,15,8,7,48,29,19,53
2799671,01/02/24,Wolverhampton,30,6,0,6,14,10,31,39,-8,32
2799671,01/02/24,Watford,30,4,5,9,7,14,25,37,-12,34
2799671,01/02/24,London Guns,30,6,8,14,11,5,55,32,23,53
2799671,01/02/24,Everton,30,8,6,14,6,10,44,38,6,48
2799671,01/02/24,Burnley,30,3,5,8,11,11,33,38,-5,35
2799671,01/02/24,Southampton,30,7,0,7,8,15,20,32,-12,29
2799671,01/02/24,Leicester,30,8,3,11,3,16,32,44,-12,36
2799671,01/02/24,Crystal Palace,30,4,3,7,11,12,36,51,-15,32
2799671,01/02/24,Newcastle,30,3,0,3,8,19,26,57,-31,17
2799695,01/02/24,Chelsea,30,6,7,13,10,7,50,33,17,49
2799695,01/02/24,Liverpool,30,7,5,12,9,9,47,36,11,45
2799695,01/02/24,Tottenham,30,7,7,14,11,5,61,37,24,53
2799695,01/02/24,Manchester Blue,30,7,11,18,7,5,61,40,21,61
2799695,01/02/24,Bournemouth,30,9,7,16,6,8,49,29,20,54
2799695,01/02/24,West Ham,30,4,2,6,9,15,29,56,-27,27
2799695,01/02/24,Manchester Reds,30,12,4,16,6,8,48,30,18,54
2799695,01/02/24,Wolverhampton,30,8,2,10,8,12,34,41,-7,38
2799695,01/02/24,Watford,30,5,3,8,8,14,31,42,-11,32
2799695,01/02/24,London Guns,30,8,7,15,6,9,50,32,18,51
2799695,01/02/24,Everton,30,6,4,10,7,13,47,46,1,37
2799695,01/02/24,Burnley,30,6,4,10,5,15,25,33,-8,35
2799695,01/02/24,Southampton,30,4,3,7,8,15,25,48,-23,29
2799695,01/02/24,Leicester,30,8,5,13,7,10,46,44,2,46
2799695,01/02/24,Crystal Palace,30,6,2,8,5,17,29,58,-29,29
2799695,01/02/24,Newcastle,30,6,0,6,4,20,26,53,-27,22
2799724,02/02/24,Chelsea,30,9,10,19,5,6,49,25,24,62
2799724,02/02/24,Liverpool,30,8,9,17,7,6,51,25,26,58
2799724,02/02/24,Tottenham,30,9,5,14,8,8,48,34,14,50
2799724,02/02/24,Manchester Blue,30,8,4,12,8,10,48,46,2,44
2799724,02/02/24,Bournemouth,30,7,6,13,8,9,47,36,11,47
2799724,02/02/24,West Ham,30,3,5,8,8,14,26,43,-17,32
2799724,02/02/24,Manchester Reds,30,10,4,14,5,11,40,33,7,47
2799724,02/02/24,Wolverhampton,30,7,5,12,13,5,28,23,5,49
2799724,02/02/24,Watford,30,7,3,10,10,10,33,28,5,40
2799724,02/02/24,London Guns,30,7,8,15,7,8,47,27,20,52
2799724,02/02/24,Everton,30,5,8,13,10,7,38,31,7,49
2799724,02/02/24,Burnley,30,4,2,6,7,17,26,42,-16,25
2799724,02/02/24,Southampton,30,0,4,4,13,13,18,36,-18,25
2799724,02/02/24,Leicester,30,5,4,9,4,17,42,53,-11,31
2799724,02/02/24,Crystal Palace,30,3,0,3,12,15,20,52,-32,21
2799724,02/02/24,Newcastle,30,3,2,5,7,18,20,47,-27,22
2799747,02/02/24,Chelsea,30,8,8,16,6,8,46,38,8,54
2799747,02/02/24,Liverpool,30,7,5,12,11,7,49,31,18,47
2799747,02/02/24,Tottenham,30,9,10,19,6,5,55,29,26,63
2799747,02/02/24,Manchester Blue,30,10,7,17,8,5,58,24,34,59
2799747,02/02/24,Bournemouth,30,7,3,10,9,11,35,29,6,39
2799747,02/02/24,West Ham,30,4,4,8,5,17,27,51,-24,29
2799747,02/02/24,Manchester Reds,30,8,4,12,5,13,31,37,-6,41
2799747,02/02/24,Wolverhampton,30,8,3,11,8,11,36,40,-4,41
2799747,02/02/24,Watford,30,8,6,14,7,9,47,39,8,49
2799747,02/02/24,London Guns,30,11,9,20,6,4,67,28,39,66
2799747,02/02/24,Everton,30,8,3,11,8,11,44,47,-3,41
2799747,02/02/24,Burnley,30,5,4,9,6,15,34,42,-8,33
2799747,02/02/24,Southampton,30,2,1,3,8,19,19,49,-30,17
2799747,02/02/24,Leicester,30,7,3,10,8,12,35,43,-8,38
2799747,02/02/24,Crystal Palace,30,5,1,6,7,17,29,51,-22,25
2799747,02/02/24,Newcastle,30,3,2,5,6,19,22,56,-34,21
2799774,02/02/24,Chelsea,30,10,11,21,6,3,60,21,39,69
2799774,02/02/24,Liverpool,30,11,6,17,5,8,64,35,29,56
2799774,02/02/24,Tottenham,30,7,5,12,8,10,48,38,10,44
2799774,02/02/24,Manchester Blue,30,11,9,20,5,5,64,27,37,65
2799774,02/02/24,Bournemouth,30,11,4,15,11,4,45,22,23,56
2799774,02/02/24,West Ham,30,6,2,8,6,16,26,50,-24,30
2799774,02/02/24,Manchester Reds,30,9,8,17,4,9,42,33,9,55
2799774,02/02/24,Wolverhampton,30,6,2,8,7,15,27,40,-13,31
2799774,02/02/24,Watford,30,6,4,10,6,14,34,44,-10,36
2799774,02/02/24,London Guns,30,10,4,14,4,12,54,43,11,46
2799774,02/02/24,Everton,30,6,4,10,7,13,32,48,-16,37
2799774,02/02/24,Burnley,30,5,6,11,4,15,27,39,-12,37
2799774,02/02/24,Southampton,30,5,3,8,7,15,28,45,-17,31
2799774,02/02/24,Leicester,30,4,5,9,5,16,29,47,-18,32
2799774,02/02/24,Crystal Palace,30,4,1,5,8,17,23,46,-23,23
2799774,02/02/24,Newcastle,30,0,3,3,11,16,28,53,-25,20
2799799,02/02/24,Chelsea,30,9,6,15,8,7,38,24,14,53
2799799,02/02/24,Liverpool,30,9,9,18,4,8,52,33,19,58
2799799,02/02/24,Tottenham,30,13,5,18,6,6,50,28,22,60
2799799,02/02/24,Manchester Blue,30,11,12,23,2,5,68,31,37,71
2799799,02/02/24,Bournemouth,30,5,5,10,8,12,37,36,1,38
2799799,02/02/24,West Ham,30,3,0,3,8,19,22,47,-25,17
2799799,02/02/24,Manchester Reds,30,9,5,14,9,7,43,33,10,51
2799799,02/02/24,Wolverhampton,30,7,4,11,10,9,37,39,-2,43
2799799,02/02/24,Watford,30,6,4,10,6,14,35,47,-12,36
2799799,02/02/24,London Guns,30,9,5,14,5,11,45,37,8,47
2799799,02/02/24,Everton,30,8,6,14,8,8,45,37,8,50
2799799,02/02/24,Burnley,30,4,4,8,6,16,29,46,-17,30
2799799,02/02/24,Southampton,30,4,4,8,9,13,34,37,-3,33
2799799,02/02/24,Leicester,30,2,2,4,9,17,30,47,-17,21
2799799,02/02/24,Crystal Palace,30,3,4,7,4,19,25,55,-30,25
2799799,02/02/24,Newcastle,30,6,1,7,10,13,26,39,-13,31
2799825,02/02/24,Chelsea,30,12,5,17,7,6,53,24,29,58
2799825,02/02/24,Liverpool,30,9,7,16,10,4,61,35,26,58
2799825,02/02/24,Tottenham,30,7,5,12,7,11,46,48,-2,43
2799825,02/02/24,Manchester Blue,30,9,9,18,8,4,66,35,31,62
2799825,02/02/24,Bournemouth,30,3,6,9,9,12,33,32,1,36
2799825,02/02/24,West Ham,30,7,1,8,6,16,42,55,-13,30
2799825,02/02/24,Manchester Reds,30,9,6,15,9,6,51,33,18,54
2799825,02/02/24,Wolverhampton,30,3,1,4,14,12,17,37,-20,26
2799825,02/02/24,Watford,30,7,4,11,9,10,38,34,4,42
2799825,02/02/24,London Guns,30,10,6,16,5,9,50,36,14,53
2799825,02/02/24,Everton,30,6,4,10,2,18,39,47,-8,32
2799825,02/02/24,Burnley,30,4,3,7,11,12,29,45,-16,32
2799825,02/02/24,Southampton,30,3,0,3,10,17,18,47,-29,19
2799825,02/02/24,Leicester,30,6,6,12,5,13,47,54,-7,41
2799825,02/02/24,Crystal Palace,30,8,2,10,8,12,28,39,-11,38
2799825,02/02/24,Newcastle,30,6,2,8,8,14,24,41,-17,32
2799849,02/02/24,Chelsea,30,10,4,14,8,8,49,26,23,50
2799849,02/02/24,Liverpool,30,11,7,18,8,4,52,25,27,62
2799849,02/02/24,Tottenham,30,7,5,12,13,5,47,36,11,49
2799849,02/02/24,Manchester Blue,30,9,4,13,9,8,48,34,14,48
2799849,02/02/24,Bournemouth,30,9,3,12,9,9,29,26,3,45
2799849,02/02/24,West Ham,30,5,2,7,8,15,29,39,-10,29
2799849,02/02/24,Manchester Reds,30,8,5,13,11,6,47,31,16,50
2799849,02/02/24,Wolverhampton,30,3,2,5,5,20,14,41,-27,20
2799849,02/02/24,Watford,30,8,1,9,8,13,33,40,-7,35
2799849,02/02/24,London Guns,30,9,10,19,4,7,52,32,20,61
2799849,02/02/24,Everton,30,6,6,12,8,10,45,45,0,44
2799849,02/02/24,Burnley,30,4,4,8,12,10,22,24,-2,36
2799849,02/02/24,Southampton,30,7,2,9,8,13,27,40,-13,35
2799849,02/02/24,Leicester,30,5,3,8,4,18,31,48,-17,28
2799849,02/02/24,Crystal Palace,30,8,5,13,6,11,32,30,2,45
2799849,02/02/24,Newcastle,30,4,2,6,3,21,24,64,-40,21
2799876,02/02/24,Chelsea,30,11,7,18,7,5,43,19,24,61
2799876,02/02/24,Liverpool,30,8,6,14,9,7,43,21,22,51
2799876,02/02/24,Tottenham,30,7,7,14,6,10,51,37,14,48
2799876,02/02/24,Manchester Blue,30,12,7,19,5,6,57,21,36,62
2799876,02/02/24,Bournemouth,30,8,5,13,5,12,35,31,4,44
2799876,02/02/24,West Ham,30,5,4,9,6,15,25,37,-12,33
2799876,02/02/24,Manchester Reds,30,8,5,13,6,11,45,39,6,45
2799876,02/02/24,Wolverhampton,30,6,7,13,6,11,33,30,3,45
2799876,02/02/24,Watford,30,7,6,13,7,10,37,41,-4,46
2799876,02/02/24,London Guns,30,4,7,11,11,8,37,30,7,44
2799876,02/02/24,Everton,30,7,2,9,6,15,41,46,-5,33
2799876,02/02/24,Burnley,30,3,2,5,10,15,18,41,-23,25
2799876,02/02/24,Southampton,30,5,3,8,6,16,20,42,-22,30
2799876,02/02/24,Leicester,30,5,5,10,6,14,34,49,-15,36
2799876,02/02/24,Crystal Palace,30,5,5,10,6,14,27,41,-14,36
2799876,02/02/24,Newcastle,30,5,2,7,6,17,21,42,-21,27
2799901,02/02/24,Chelsea,30,8,6,14,5,11,42,41,1,47
2799901,02/02/24,Liverpool,30,11,6,17,3,10,66,37,29,54
2799901,02/02/24,Tottenham,30,5,8,13,8,9,40,36,4,47
2799901,02/02/24,Manchester Blue,30,7,9,16,7,7,57,31,26,55
2799901,02/02/24,Bournemouth,30,11,9,20,4,6,48,25,23,64
2799901,02/02/24,West Ham,30,7,5,12,7,11,38,45,-7,43
2799901,02/02/24,Manchester Reds,30,10,4,14,5,11,50,37,13,47
2799901,02/02/24,Wolverhampton,30,7,4,11,6,13,32,35,-3,39
2799901,02/02/24,Watford,30,6,3,9,8,13,26,39,-13,35
2799901,02/02/24,London Guns,30,9,6,15,4,11,40,34,6,49
2799901,02/02/24,Everton,30,10,2,12,7,11,42,41,1,43
2799901,02/02/24,Burnley,30,7,5,12,4,14,33,36,-3,40
2799901,02/02/24,Southampton,30,4,2,6,7,17,24,39,-15,25
2799901,02/02/24,Leicester,30,6,4,10,7,13,35,40,-5,37
2799901,02/02/24,Crystal Palace,30,2,2,4,6,20,29,63,-34,18
2799901,02/02/24,Newcastle,30,3,5,8,6,16,25,48,-23,30
2799929,02/02/24,Chelsea,30,10,6,16,5,9,53,37,16,53
2799929,02/02/24,Liverpool,30,10,6,16,9,5,52,30,22,57
2799929,02/02/24,Tottenham,30,8,4,12,11,7,50,34,16,47
2799929,02/02/24,Manchester Blue,30,9,7,16,5,9,53,30,23,53
2799929,02/02/24,Bournemouth,30,8,6,14,10,6,38,29,9,52
2799929,02/02/24,West Ham,30,1,1,2,14,14,29,52,-23,20
2799929,02/02/24,Manchester Reds,30,7,6,13,4,13,47,37,10,43
2799929,02/02/24,Wolverhampton,30,7,5,12,12,6,38,27,11,48
2799929,02/02/24,Watford,30,4,2,6,8,16,25,52,-27,26
2799929,02/02/24,London Guns,30,8,9,17,4,9,45,40,5,55
2799929,02/02/24,Everton,30,8,5,13,9,8,49,38,11,48
2799929,02/02/24,Burnley,30,4,2,6,9,15,22,38,-16,27
2799929,02/02/24,Southampton,30,2,3,5,8,17,23,44,-21,23
2799929,02/02/24,Leicester,30,9,1,10,7,13,40,45,-5,37
2799929,02/02/24,Crystal Palace,30,4,4,8,8,14,29,42,-13,32
2799929,02/02/24,Newcastle,30,5,3,8,9,13,31,49,-18,33
2799951,02/02/24,Chelsea,30,12,6,18,8,4,51,22,29,62
2799951,02/02/24,Liverpool,30,9,7,16,10,4,54,27,27,58
2799951,02/02/24,Tottenham,30,7,2,9,11,10,45,40,5,38
2799951,02/02/24,Manchester Blue,30,7,4,11,12,7,54,45,9,45
2799951,02/02/24,Bournemouth,30,8,5,13,9,8,34,23,11,48
2799951,02/02/24,West Ham,30,6,3,9,5,16,32,50,-18,32
2799951,02/02/24,Manchester Reds,30,7,6,13,11,6,47,38,9,50
2799951,02/02/24,Wolverhampton,30,8,3,11,9,10,37,33,4,42
2799951,02/02/24,Watford,30,6,3,9,9,12,34,43,-9,36
2799951,02/02/24,London Guns,30,9,4,13,10,7,53,39,14,49
2799951,02/02/24,Everton,30,6,5,11,4,15,42,48,-6,37
2799951,02/02/24,Burnley,30,4,6,10,6,14,31,41,-10,36
2799951,02/02/24,Southampton,30,2,2,4,12,14,27,43,-16,24
2799951,02/02/24,Leicester,30,9,6,15,5,10,58,50,8,50
2799951,02/02/24,Crystal Palace,30,3,0,3,8,19,23,58,-35,17
2799951,02/02/24,Newcastle,30,5,2,7,7,16,30,52,-22,28
2799978,02/02/24,Chelsea,30,6,5,11,9,10,35,30,5,42
2799978,02/02/24,Liverpool,30,11,7,18,4,8,52,35,17,58
2799978,02/02/24,Tottenham,30,9,7,16,10,4,50,23,27,58
2799978,02/02/24,Manchester Blue,30,10,9,19,4,7,66,44,22,61
2799978,02/02/24,Bournemouth,30,9,5,14,6,10,47,38,9,48
2799978,02/02/24,West Ham,30,5,7,12,5,13,45,51,-6,41
2799978,02/02/24,Manchester Reds,30,8,7,15,8,7,42,30,12,53
2799978,02/02/24,Wolverhampton,30,5,6,11,6,13,37,42,-5,39
2799978,02/02/24,Watford,30,8,4,12,7,11,41,38,3,43
2799978,02/02/24,London Guns,30,7,5,12,10,8,43,34,9,46
2799978,02/02/24,Everton,30,5,4,9,8,13,35,45,-10,35
2799978,02/02/24,Burnley,30,4,2,6,9,15,26,43,-17,27
2799978,02/02/24,Southampton,30,3,2,5,8,17,32,54,-22,23
2799978,02/02/24,Leicester,30,7,4,11,7,12,45,44,1,40
2799978,02/02/24,Crystal Palace,30,6,1,7,6,17,30,50,-20,27
2799978,02/02/24,Newcastle,30,3,0,3,11,16,23,48,-25,20
2800003,02/02/24,Chelsea,30,10,6,16,4,10,43,36,7,52
2800003,02/02/24,Liverpool,30,11,8,19,7,4,48,23,25,64
2800003,02/02/24,Tottenham,30,11,6,17,6,7,61,37,24,57
2800003,02/02/24,Manchester Blue,30,6,10,16,11,3,63,29,34,59
2800003,02/02/24,Bournemouth,30,10,5,15,8,7,44,32,12,53
2800003,02/02/24,West Ham,30,3,3,6,10,14,32,49,-17,28
2800003,02/02/24,Manchester Reds,30,7,4,11,7,12,45,38,7,40
2800003,02/02/24,Wolverhampton,30,4,4,8,8,14,32,42,-10,32
2800003,02/02/24,Watford,30,3,4,7,11,12,36,39,-3,32
2800003,02/02/24,London Guns,30,10,6,16,6,8,56,35,21,54
2800003,02/02/24,Everton,30,6,5,11,7,12,41,48,-7,40
2800003,02/02/24,Burnley,30,5,2,7,6,17,27,43,-16,27
2800003,02/02/24,Southampton,30,3,3,6,5,19,28,54,-26,23
2800003,02/02/24,Leicester,30,6,5,11,7,12,40,49,-9,40
2800003,02/02/24,Crystal Palace,30,4,4,8,6,16,38,58,-20,30
2800003,02/02/24,Newcastle,30,4,4,8,7,15,24,46,-22,31
2800029,02/02/24,Chelsea,30,10,7,17,8,5,50,24,26,59
2800029,02/02/24,Liverpool,30,9,7,16,4,10,48,36,12,52
2800029,02/02/24,Tottenham,30,10,8,18,3,9,61,40,21,57
2800029,02/02/24,Manchester Blue,30,9,5,14,4,12,47,47,0,46
2800029,02/02/24,Bournemouth,30,8,8,16,3,11,47,35,12,51
2800029,02/02/24,West Ham,30,3,3,6,8,16,23,43,-20,26
2800029,02/02/24,Manchester Reds,30,11,3,14,7,9,54,35,19,49
2800029,02/02/24,Wolverhampton,30,4,6,10,9,11,33,34,-1,39
2800029,02/02/24,Watford,30,8,3,11,8,11,39,29,10,41
2800029,02/02/24,London Guns,30,11,5,16,7,7,52,36,16,55
2800029,02/02/24,Everton,30,7,2,9,10,11,40,45,-5,37
2800029,02/02/24,Burnley,30,5,3,8,10,12,25,36,-11,34
2800029,02/02/24,Southampton,30,8,3,11,9,10,27,30,-3,42
2800029,02/02/24,Leicester,30,3,4,7,4,19,29,59,-30,25
2800029,02/02/24,Crystal Palace,30,6,2,8,6,16,30,57,-27,30
2800029,02/02/24,Newcastle,30,5,1,6,6,18,29,48,-19,24
2800056,03/02/24,Chelsea,30,8,5,13,9,8,50,40,10,48
2800056,03/02/24,Liverpool,30,12,10,22,4,4,63,20,43,70
2800056,03/02/24,Tottenham,30,6,5,11,8,11,45,43,2,41
2800056,03/02/24,Manchester Blue,30,8,6,14,12,4,38,16,22,54
2800056,03/02/24,Bournemouth,30,4,1,5,8,17,21,39,-18,23
2800056,03/02/24,West Ham,30,5,4,9,6,15,27,38,-11,33
2800056,03/02/24,Manchester Reds,30,7,3,10,11,9,45,36,9,41
2800056,03/02/24,Wolverhampton,30,8,7,15,5,10,38,28,10,50
2800056,03/02/24,Watford,30,5,6,11,3,16,34,44,-10,36
2800056,03/02/24,London Guns,30,6,9,15,9,6,37,22,15,54
2800056,03/02/24,Everton,30,7,4,11,8,11,30,43,-13,41
2800056,03/02/24,Burnley,30,5,5,10,11,9,31,31,0,41
2800056,03/02/24,Southampton,30,5,3,8,9,13,20,34,-14,33
2800056,03/02/24,Leicester,30,6,1,7,6,17,30,50,-20,27
2800056,03/02/24,Crystal Palace,30,9,4,13,4,13,38,42,-4,43
2800056,03/02/24,Newcastle,30,1,2,3,13,14,21,42,-21,22
2800082,03/02/24,Chelsea,30,9,6,15,9,6,48,25,23,54
2800082,03/02/24,Liverpool,30,8,6,14,9,7,50,33,17,51
2800082,03/02/24,Tottenham,30,6,6,12,9,9,49,36,13,45
2800082,03/02/24,Manchester Blue,30,9,13,22,4,4,60,19,41,70
2800082,03/02/24,Bournemouth,30,6,7,13,7,10,45,42,3,46
2800082,03/02/24,West Ham,30,6,2,8,7,15,33,46,-13,31
2800082,03/02/24,Manchester Reds,30,9,6,15,5,10,48,33,15,50
2800082,03/02/24,Wolverhampton,30,7,3,10,8,12,30,40,-10,38
2800082,03/02/24,Watford,30,8,3,11,9,10,33,36,-3,42
2800082,03/02/24,London Guns,30,7,6,13,8,9,45,31,14,47
2800082,03/02/24,Everton,30,6,3,9,6,15,33,56,-23,33
2800082,03/02/24,Burnley,30,2,1,3,7,20,22,54,-32,16
2800082,03/02/24,Southampton,30,3,5,8,8,14,25,38,-13,32
2800082,03/02/24,Leicester,30,6,4,10,5,15,47,57,-10,35
2800082,03/02/24,Crystal Palace,30,5,6,11,6,13,37,44,-7,39
2800082,03/02/24,Newcastle,30,5,3,8,9,13,29,44,-15,33
2800107,03/02/24,Chelsea,30,9,10,19,5,6,60,31,29,62
2800107,03/02/24,Liverpool,30,9,4,13,9,8,46,31,15,48
2800107,03/02/24,Tottenham,30,7,4,11,9,10,37,37,0,42
2800107,03/02/24,Manchester Blue,30,9,8,17,5,8,58,35,23,56
2800107,03/02/24,Bournemouth,30,9,4,13,10,7,45,30,15,49
2800107,03/02/24,West Ham,30,5,2,7,7,16,22,43,-21,28
2800107,03/02/24,Manchester Reds,30,5,7,12,9,9,38,37,1,45
2800107,03/02/24,Wolverhampton,30,2,4,6,7,17,23,43,-20,25
2800107,03/02/24,Watford,30,4,7,11,7,12,34,39,-5,40
2800107,03/02/24,London Guns,30,10,8,18,6,6,51,29,22,60
2800107,03/02/24,Everton,30,7,4,11,6,13,42,44,-2,39
2800107,03/02/24,Burnley,30,6,4,10,8,12,23,29,-6,38
2800107,03/02/24,Southampton,30,4,5,9,11,10,33,34,-1,38
2800107,03/02/24,Leicester,30,6,2,8,9,13,38,46,-8,33
2800107,03/02/24,Crystal Palace,30,3,6,9,8,13,31,50,-19,35
2800107,03/02/24,Newcastle,30,2,2,4,8,18,28,51,-23,20
2800132,03/02/24,Chelsea,30,10,6,16,11,3,47,22,25,59
2800132,03/02/24,Liverpool,30,7,5,12,5,13,47,40,7,41
2800132,03/02/24,Tottenham,30,8,6,14,4,12,45,42,3,46
2800132,03/02/24,Manchester Blue,30,13,9,22,5,3,59,22,37,71
2800132,03/02/24,Bournemouth,30,8,6,14,7,9,51,35,16,49
2800132,03/02/24,West Ham,30,7,1,8,4,18,33,62,-29,28
2800132,03/02/24,Manchester Reds,30,12,7,19,6,5,53,26,27,63
2800132,03/02/24,Wolverhampton,30,6,7,13,11,6,33,22,11,50
2800132,03/02/24,Watford,30,8,2,10,7,13,32,33,-1,37
2800132,03/02/24,London Guns,30,10,6,16,3,11,62,34,28,51
2800132,03/02/24,Everton,30,6,3,9,5,16,38,54,-16,32
2800132,03/02/24,Burnley,30,5,3,8,4,18,31,48,-17,28
2800132,03/02/24,Southampton,30,5,3,8,6,16,24,46,-22,30
2800132,03/02/24,Leicester,30,9,3,12,4,14,46,55,-9,40
2800132,03/02/24,Crystal Palace,30,4,1,5,8,17,27,60,-33,23
2800132,03/02/24,Newcastle,30,4,1,5,8,17,25,52,-27,23
2800158,03/02/24,Chelsea,30,7,9,16,10,4,53,27,26,58
2800158,03/02/24,Liverpool,30,7,7,14,11,5,42,27,15,53
2800158,03/02/24,Tottenham,30,7,3,10,11,9,44,35,9,41
2800158,03/02/24,Manchester Blue,30,10,5,15,8,7,45,27,18,53
2800158,03/02/24,Bournemouth,30,7,6,13,6,11,40,34,6,45
2800158,03/02/24,West Ham,30,2,2,4,7,19,22,60,-38,19
2800158,03/02/24,Manchester Reds,30,9,9,18,8,4,60,26,34,62
2800158,03/02/24,Wolverhampton,30,4,5,9,16,5,35,22,13,43
2800158,03/02/24,Watford,30,4,1,5,10,15,30,45,-15,25
2800158,03/02/24,London Guns,30,10,7,17,5,8,62,32,30,56
2800158,03/02/24,Everton,30,7,5,12,4,14,37,48,-11,40
2800158,03/02/24,Burnley,30,7,2,9,6,15,21,36,-15,33
2800158,03/02/24,Southampton,30,3,1,4,7,19,16,52,-36,19
2800158,03/02/24,Leicester,30,4,7,11,6,13,43,42,1,39
2800158,03/02/24,Crystal Palace,30,6,5,11,7,12,33,41,-8,40
2800158,03/02/24,Newcastle,30,5,1,6,10,14,21,50,-29,28
2800183,03/02/24,Chelsea,30,8,5,13,7,10,45,30,15,46
2800183,03/02/24,Liverpool,30,9,9,18,4,8,52,36,16,58
2800183,03/02/24,Tottenham,30,7,6,13,9,8,44,32,12,48
2800183,03/02/24,Manchester Blue,30,9,8,17,6,7,51,29,22,57
2800183,03/02/24,Bournemouth,30,7,7,14,10,6,46,39,7,52
2800183,03/02/24,West Ham,30,6,5,11,5,14,28,38,-10,38
2800183,03/02/24,Manchester Reds,30,8,3,11,10,9,43,39,4,43
2800183,03/02/24,Wolverhampton,30,6,4,10,7,13,24,31,-7,37
2800183,03/02/24,Watford,30,7,4,11,7,12,28,34,-6,40
2800183,03/02/24,London Guns,30,12,7,19,6,5,59,34,25,63
2800183,03/02/24,Everton,30,6,4,10,9,11,41,40,1,39
2800183,03/02/24,Burnley,30,5,3,8,8,14,25,34,-9,32
2800183,03/02/24,Southampton,30,3,3,6,10,14,28,41,-13,28
2800183,03/02/24,Leicester,30,7,0,7,8,15,38,55,-17,29
2800183,03/02/24,Crystal Palace,30,5,0,5,9,16,29,52,-23,24
2800183,03/02/24,Newcastle,30,5,0,5,9,16,25,42,-17,24
2800213,03/02/24,Chelsea,30,11,10,21,5,4,59,25,34,68
2800213,03/02/24,Liverpool,30,11,5,16,8,6,53,27,26,56
2800213,03/02/24,Tottenham,30,7,2,9,7,14,36,51,-15,34
2800213,03/02/24,Manchester Blue,30,12,6,18,7,5,54,25,29,61
2800213,03/02/24,Bournemouth,30,9,8,17,5,8,50,28,22,56
2800213,03/02/24,West Ham,30,3,4,7,7,16,25,44,-19,28
2800213,03/02/24,Manchester Reds,30,6,8,14,11,5,46,35,11,53
2800213,03/02/24,Wolverhampton,30,3,6,9,10,11,29,29,0,37
2800213,03/02/24,Watford,30,8,1,9,6,15,27,41,-14,33
2800213,03/02/24,London Guns,30,5,10,15,7,8,54,39,15,52
2800213,03/02/24,Everton,30,10,2,12,6,12,38,42,-4,42
2800213,03/02/24,Burnley,30,4,3,7,8,15,27,41,-14,29
2800213,03/02/24,Southampton,30,5,1,6,8,16,24,49,-25,26
2800213,03/02/24,Leicester,30,9,3,12,4,14,47,45,2,40
2800213,03/02/24,Crystal Palace,30,4,3,7,5,18,29,56,-27,26
2800213,03/02/24,Newcastle,30,3,2,5,8,17,27,48,-21,23
2800238,03/02/24,Chelsea,30,7,7,14,7,9,37,24,13,49
2800238,03/02/24,Liverpool,30,12,9,21,5,4,57,27,30,68
2800238,03/02/24,Tottenham,30,7,9,16,5,9,60,37,23,53
2800238,03/02/24,Manchester Blue,30,10,8,18,8,4,53,27,26,62
2800238,03/02/24,Bournemouth,30,9,7,16,5,9,49,29,20,53
2800238,03/02/24,West Ham,30,3,4,7,7,16,24,46,-22,28
2800238,03/02/24,Manchester Reds,30,9,4,13,6,11,40,36,4,45
2800238,03/02/24,Wolverhampton,30,8,6,14,6,10,29,24,5,48
2800238,03/02/24,Watford,30,4,6,10,5,15,28,46,-18,35
2800238,03/02/24,London Guns,30,8,6,14,6,10,46,32,14,48
2800238,03/02/24,Everton,30,6,6,12,7,11,49,46,3,43
2800238,03/02/24,Burnley,30,8,0,8,3,19,24,55,-31,27
2800238,03/02/24,Southampton,30,5,4,9,6,15,25,40,-15,33
2800238,03/02/24,Leicester,30,5,5,10,7,13,41,46,-5,37
2800238,03/02/24,Crystal Palace,30,5,2,7,5,18,35,55,-20,26
2800238,03/02/24,Newcastle,30,1,4,5,4,21,25,52,-27,19
2800262,03/02/24,Chelsea,30,9,9,18,6,6,59,25,34,60
2800262,03/02/24,Liverpool,30,6,7,13,9,8,51,34,17,48
2800262,03/02/24,Tottenham,30,5,7,12,10,8,46,37,9,46
2800262,03/02/24,Manchester Blue,30,6,9,15,10,5,53,35,18,55
2800262,03/02/24,Bournemouth,30,5,4,9,11,10,37,39,-2,38
2800262,03/02/24,West Ham,30,4,1,5,9,16,30,65,-35,24
2800262,03/02/24,Manchester Reds,30,7,10,17,6,7,50,31,19,57
2800262,03/02/24,Wolverhampton,30,6,3,9,7,14,30,34,-4,34
2800262,03/02/24,Watford,30,7,5,12,6,12,36,42,-6,42
2800262,03/02/24,London Guns,30,8,4,12,11,7,46,33,13,47
2800262,03/02/24,Everton,30,6,4,10,9,11,45,44,1,39
2800262,03/02/24,Burnley,30,3,2,5,12,13,27,35,-8,27
2800262,03/02/24,Southampton,30,4,5,9,10,11,25,38,-13,37
2800262,03/02/24,Leicester,30,6,3,9,8,13,41,47,-6,35
2800262,03/02/24,Crystal Palace,30,4,6,10,10,10,41,45,-4,40
2800262,03/02/24,Newcastle,30,3,2,5,6,19,15,48,-33,21
2800290,03/02/24,Chelsea,30,12,8,20,5,5,52,20,32,65
2800290,03/02/24,Liverpool,30,10,7,17,10,3,68,27,41,61
2800290,03/02/24,Tottenham,30,10,4,14,9,7,51,33,18,51
2800290,03/02/24,Manchester Blue,30,8,6,14,8,8,51,38,13,50
2800290,03/02/24,Bournemouth,30,9,6,15,9,6,42,26,16,54
2800290,03/02/24,West Ham,30,6,0,6,5,19,24,55,-31,23
2800290,03/02/24,Manchester Reds,30,8,6,14,7,9,46,45,1,49
2800290,03/02/24,Wolverhampton,30,7,5,12,6,12,34,35,-1,42
2800290,03/02/24,Watford,30,7,2,9,9,12,35,39,-4,36
2800290,03/02/24,London Guns,30,8,7,15,6,9,53,40,13,51
2800290,03/02/24,Everton,30,5,4,9,10,11,40,48,-8,37
2800290,03/02/24,Burnley,30,1,5,6,10,14,24,39,-15,28
2800290,03/02/24,Southampton,30,3,4,7,10,13,29,44,-15,31
2800290,03/02/24,Leicester,30,4,3,7,5,18,31,59,-28,26
2800290,03/02/24,Crystal Palace,30,8,1,9,5,16,35,45,-10,32
2800290,03/02/24,Newcastle,30,5,1,6,6,18,31,53,-22,24
2800314,03/02/24,Chelsea,30,9,7,16,8,6,54,32,22,56
2800314,03/02/24,Liverpool,30,9,7,16,8,6,53,27,26,56
2800314,03/02/24,Tottenham,30,7,5,12,5,13,37,37,0,41
2800314,03/02/24,Manchester Blue,30,12,7,19,3,8,61,30,31,60
2800314,03/02/24,Bournemouth,30,9,6,15,8,7,41,24,17,53
2800314,03/02/24,West Ham,30,7,4,11,7,12,32,38,-6,40
2800314,03/02/24,Manchester Reds,30,8,2,10,9,11,34,31,3,39
2800314,03/02/24,Wolverhampton,30,7,8,15,9,6,29,20,9,54
2800314,03/02/24,Watford,30,5,2,7,5,18,25,50,-25,26
2800314,03/02/24,London Guns,30,6,6,12,8,10,43,39,4,44
2800314,03/02/24,Everton,30,8,6,14,5,11,36,32,4,47
2800314,03/02/24,Burnley,30,7,1,8,6,16,24,44,-20,30
2800314,03/02/24,Southampton,30,3,2,5,7,18,21,44,-23,22
2800314,03/02/24,Leicester,30,6,4,10,6,14,35,49,-14,36
2800314,03/02/24,Crystal Palace,30,5,2,7,6,17,30,48,-18,27
2800314,03/02/24,Newcastle,30,5,4,9,8,13,26,36,-10,35
2800340,03/02/24,Chelsea,30,8,7,15,3,12,48,37,11,48
2800340,03/02/24,Liverpool,30,7,7,14,7,9,48,34,14,49
2800340,03/02/24,Tottenham,30,11,6,17,4,9,51,37,14,55
2800340,03/02/24,Manchester Blue,30,8,11,19,4,7,50,19,31,61
2800340,03/02/24,Bournemouth,30,10,8,18,7,5,53,25,28,61
2800340,03/02/24,West Ham,30,5,3,8,9,13,32,45,-13,33
2800340,03/02/24,Manchester Reds,30,10,4,14,6,10,43,37,6,48
2800340,03/02/24,Wolverhampton,30,4,4,8,9,13,23,37,-14,33
2800340,03/02/24,Watford,30,8,5,13,6,11,33,42,-9,45
2800340,03/02/24,London Guns,30,7,6,13,7,10,47,40,7,46
2800340,03/02/24,Everton,30,7,6,13,5,12,43,45,-2,44
2800340,03/02/24,Burnley,30,3,2,5,6,19,19,44,-25,21
2800340,03/02/24,Southampton,30,4,2,6,6,18,23,42,-19,24
2800340,03/02/24,Leicester,30,3,4,7,7,16,35,50,-15,28
2800340,03/02/24,Crystal Palace,30,4,3,7,8,15,33,45,-12,29
2800340,03/02/24,Newcastle,30,9,5,14,4,12,39,41,-2,46
2800366,03/02/24,Chelsea,30,7,8,15,7,8,33,30,3,52
2800366,03/02/24,Liverpool,30,11,8,19,4,7,58,29,29,61
2800366,03/02/24,Tottenham,30,6,3,9,10,11,33,40,-7,37
2800366,03/02/24,Manchester Blue,30,7,9,16,5,9,55,38,17,53
2800366,03/02/24,Bournemouth,30,9,9,18,4,8,50,25,25,58
2800366,03/02/24,West Ham,30,4,1,5,6,19,32,50,-18,21
2800366,03/02/24,Manchester Reds,30,9,7,16,8,6,57,30,27,56
2800366,03/02/24,Wolverhampton,30,8,2,10,9,11,24,36,-12,39
2800366,03/02/24,Watford,30,3,4,7,15,8,33,29,4,36
2800366,03/02/24,London Guns,30,10,8,18,4,8,50,32,18,58
2800366,03/02/24,Everton,30,6,8,14,10,6,46,38,8,52
2800366,03/02/24,Burnley,30,4,1,5,7,18,16,43,-27,22
2800366,03/02/24,Southampton,30,5,0,5,12,13,27,49,-22,27
2800366,03/02/24,Leicester,30,6,4,10,7,13,32,40,-8,37
2800366,03/02/24,Crystal Palace,30,2,2,4,11,15,24,51,-27,23
2800366,03/02/24,Newcastle,30,5,1,6,7,17,40,50,-10,25
2800394,04/02/24,Chelsea,30,10,8,18,3,9,52,32,20,57
2800394,04/02/24,Liverpool,30,11,9,20,4,6,48,25,23,64
2800394,04/02/24,Tottenham,30,9,7,16,6,8,52,39,13,54
2800394,04/02/24,Manchester Blue,30,10,7,17,8,5,65,37,28,59
2800394,04/02/24,Bournemouth,30,9,7,16,10,4,48,29,19,58
2800394,04/02/24,West Ham,30,3,2,5,6,19,23,53,-30,21
2800394,04/02/24,Manchester Reds,30,11,6,17,5,8,44,26,18,56
2800394,04/02/24,Wolverhampton,30,7,4,11,7,12,36,35,1,40
2800394,04/02/24,Watford,30,7,2,9,4,17,33,43,-10,31
2800394,04/02/24,London Guns,30,6,7,13,9,8,48,35,13,48
2800394,04/02/24,Everton,30,8,3,11,5,14,32,38,-6,38
2800394,04/02/24,Burnley,30,7,4,11,5,14,26,35,-9,38
2800394,04/02/24,Southampton,30,3,3,6,4,20,20,47,-27,22
2800394,04/02/24,Leicester,30,8,4,12,6,12,41,44,-3,42
2800394,04/02/24,Crystal Palace,30,4,1,5,6,19,26,61,-35,21
2800394,04/02/24,Newcastle,30,6,1,7,4,19,30,45,-15,25
2800420,04/02/24,Chelsea,30,6,10,16,7,7,44,23,21,55
2800420,04/02/24,Liverpool,30,7,6,13,9,8,42,31,11,48
2800420,04/02/24,Tottenham,30,10,5,15,7,8,38,34,4,52
2800420,04/02/24,Manchester Blue,30,6,5,11,11,8,52,35,17,44
2800420,04/02/24,Bournemouth,30,12,6,18,7,5,59,23,36,61
2800420,04/02/24,West Ham,30,4,4,8,7,15,26,45,-19,31
2800420,04/02/24,Manchester Reds,30,10,6,16,7,7,48,32,16,55
2800420,04/02/24,Wolverhampton,30,5,4,9,11,10,27,30,-3,38
2800420,04/02/24,Watford,30,3,6,9,9,12,24,34,-10,36
2800420,04/02/24,London Guns,30,10,6,16,9,5,52,26,26,57
2800420,04/02/24,Everton,30,6,4,10,7,13,38,46,-8,37
2800420,04/02/24,Burnley,30,4,3,7,8,15,18,38,-20,29
2800420,04/02/24,Southampton,30,1,2,3,8,19,17,42,-25,17
2800420,04/02/24,Leicester,30,7,5,12,6,12,37,43,-6,42
2800420,04/02/24,Crystal Palace,30,1,6,7,6,17,30,50,-20,27
2800420,04/02/24,Newcastle,30,4,3,7,7,16,19,39,-20,28
2800446,04/02/24,Chelsea,30,10,9,19,3,8,49,27,22,60
2800446,04/02/24,Liverpool,30,9,6,15,9,6,50,27,23,54
2800446,04/02/24,Tottenham,30,8,4,12,10,8,43,32,11,46
2800446,04/02/24,Manchester Blue,30,12,7,19,3,8,57,29,28,60
2800446,04/02/24,Bournemouth,30,6,8,14,8,8,45,32,13,50
2800446,04/02/24,West Ham,30,7,4,11,6,13,34,39,-5,39
2800446,04/02/24,Manchester Reds,30,5,9,14,8,8,40,33,7,50
2800446,04/02/24,Wolverhampton,30,5,4,9,8,13,33,43,-10,35
2800446,04/02/24,Watford,30,2,2,4,8,18,20,42,-22,20
2800446,04/02/24,London Guns,30,12,6,18,4,8,59,33,26,58
2800446,04/02/24,Everton,30,4,3,7,10,13,38,45,-7,31
2800446,04/02/24,Burnley,30,5,4,9,9,12,23,36,-13,36
2800446,04/02/24,Southampton,30,3,4,7,8,15,20,51,-31,29
2800446,04/02/24,Leicester,30,7,6,13,2,15,39,53,-14,41
2800446,04/02/24,Crystal Palace,30,4,3,7,9,14,37,43,-6,30
2800446,04/02/24,Newcastle,30,3,3,6,7,17,24,46,-22,25
2800471,04/02/24,Chelsea,30,11,6,17,9,4,57,28,29,60
2800471,04/02/24,Liverpool,30,9,3,12,8,10,39,30,9,44
2800471,04/02/24,Tottenham,30,7,7,14,7,9,43,37,6,49
2800471,04/02/24,Manchester Blue,30,11,10,21,6,3,56,22,34,69
2800471,04/02/24,Bournemouth,30,7,5,12,9,9,43,31,12,45
2800471,04/02/24,West Ham,30,5,1,6,7,17,25,44,-19,25
2800471,04/02/24,Manchester Reds,30,7,4,11,14,5,48,33,15,47
2800471,04/02/24,Wolverhampton,30,9,5,14,4,12,35,34,1,46
2800471,04/02/24,Watford,30,7,4,11,4,15,31,42,-11,37
2800471,04/02/24,London Guns,30,11,7,18,4,8,67,42,25,58
2800471,04/02/24,Everton,30,7,3,10,6,14,30,39,-9,36
2800471,04/02/24,Burnley,30,3,2,5,13,12,24,39,-15,28
2800471,04/02/24,Southampton,30,5,2,7,9,14,26,41,-15,30
2800471,04/02/24,Leicester,30,5,6,11,1,18,36,60,-24,34
2800471,04/02/24,Crystal Palace,30,2,2,4,7,19,20,49,-29,19
2800471,04/02/24,Newcastle,30,7,4,11,4,15,36,45,-9,37
2800494,04/02/24,Chelsea,30,10,6,16,6,8,47,29,18,54
2800494,04/02/24,Liverpool,30,12,7,19,5,6,52,28,24,62
2800494,04/02/24,Tottenham,30,8,4,12,5,13,48,44,4,41
2800494,04/02/24,Manchester Blue,30,10,9,19,8,3,58,23,35,65
2800494,04/02/24,Bournemouth,30,10,5,15,7,8,41,27,14,52
2800494,04/02/24,West Ham,30,6,3,9,6,15,38,46,-8,33
2800494,04/02/24,Manchester Reds,30,8,8,16,6,8,49,32,17,54
2800494,04/02/24,Wolverhampton,30,8,2,10,9,11,43,46,-3,39
2800494,04/02/24,Watford,30,6,2,8,8,14,34,40,-6,32
2800494,04/02/24,London Guns,30,10,9,19,6,5,60,38,22,63
2800494,04/02/24,Everton,30,8,4,12,9,9,39,33,6,45
2800494,04/02/24,Burnley,30,4,1,5,8,17,22,46,-24,23
2800494,04/02/24,Southampton,30,3,1,4,5,21,22,53,-31,17
2800494,04/02/24,Leicester,30,7,2,9,9,12,37,54,-17,36
2800494,04/02/24,Crystal Palace,30,4,1,5,8,17,17,48,-31,23
2800494,04/02/24,Newcastle,30,5,1,6,7,17,28,48,-20,25
2800519,04/02/24,Chelsea,30,8,8,16,8,6,51,21,30,56
2800519,04/02/24,Liverpool,30,9,8,17,8,5,62,34,28,59
2800519,04/02/24,Tottenham,30,6,7,13,7,10,48,38,10,46
2800519,04/02/24,Manchester Blue,30,9,8,17,7,6,50,32,18,58
2800519,04/02/24,Bournemouth,30,7,9,16,5,9,44,26,18,53
2800519,04/02/24,West Ham,30,3,2,5,9,16,29,51,-22,24
2800519,04/02/24,Manchester Reds,30,10,9,19,3,8,55,31,24,60
2800519,04/02/24,Wolverhampton,30,6,5,11,9,10,30,34,-4,42
2800519,04/02/24,Watford,30,7,2,9,7,14,38,38,0,34
2800519,04/02/24,London Guns,30,9,8,17,8,5,52,25,27,59
2800519,04/02/24,Everton,30,5,3,8,5,17,30,56,-26,29
2800519,04/02/24,Burnley,30,3,2,5,12,13,21,38,-17,27
2800519,04/02/24,Southampton,30,2,1,3,8,19,18,51,-33,17
2800519,04/02/24,Leicester,30,4,6,10,7,13,32,50,-18,37
2800519,04/02/24,Crystal Palace,30,8,4,12,7,11,29,41,-12,43
2800519,04/02/24,Newcastle,30,3,1,4,6,20,26,49,-23,18
2800548,04/02/24,Chelsea,30,8,6,14,6,10,54,34,20,48
2800548,04/02/24,Liverpool,30,9,7,16,6,8,50,30,20,54
2800548,04/02/24,Tottenham,30,6,11,17,7,6,46,26,20,58
2800548,04/02/24,Manchester Blue,30,9,5,14,6,10,44,35,9,48
2800548,04/02/24,Bournemouth,30,7,7,14,9,7,40,22,18,51
2800548,04/02/24,West Ham,30,5,4,9,5,16,35,48,-13,32
2800548,04/02/24,Manchester Reds,30,7,4,11,10,9,37,34,3,43
2800548,04/02/24,Wolverhampton,30,7,5,12,11,7,32,20,12,47
2800548,04/02/24,Watford,30,6,4,10,5,15,36,48,-12,35
2800548,04/02/24,London Guns,30,10,9,19,7,4,53,23,30,64
2800548,04/02/24,Everton,30,6,3,9,9,12,36,45,-9,36
2800548,04/02/24,Burnley,30,7,0,7,9,14,28,41,-13,30
2800548,04/02/24,Southampton,30,5,3,8,8,14,28,44,-16,32
2800548,04/02/24,Leicester,30,5,3,8,9,13,32,48,-16,33
2800548,04/02/24,Crystal Palace,30,2,2,4,7,19,26,67,-41,19
2800548,04/02/24,Newcastle,30,5,2,7,8,15,29,41,-12,29
2800571,04/02/24,Chelsea,30,10,7,17,6,7,50,30,20,57
2800571,04/02/24,Liverpool,30,10,6,16,5,9,52,31,21,53
2800571,04/02/24,Tottenham,30,9,6,15,7,8,51,31,20,52
2800571,04/02/24,Manchester Blue,30,10,11,21,4,5,57,23,34,67
2800571,04/02/24,Bournemouth,30,9,7,16,6,8,52,32,20,54
2800571,04/02/24,West Ham,30,6,2,8,5,17,30,42,-12,29
2800571,04/02/24,Manchester Reds,30,5,7,12,7,11,33,31,2,43
2800571,04/02/24,Wolverhampton,30,8,1,9,7,14,27,37,-10,34
2800571,04/02/24,Watford,30,7,6,13,4,13,33,38,-5,43
2800571,04/02/24,London Guns,30,10,7,17,9,4,59,33,26,60
2800571,04/02/24,Everton,30,8,3,11,5,14,37,46,-9,38
2800571,04/02/24,Burnley,30,5,2,7,7,16,28,52,-24,28
2800571,04/02/24,Southampton,30,6,2,8,2,20,25,60,-35,26
2800571,04/02/24,Leicester,30,6,3,9,9,12,38,45,-7,36
2800571,04/02/24,Crystal Palace,30,6,2,8,3,19,28,44,-16,27
2800571,04/02/24,Newcastle,30,4,2,6,8,16,21,46,-25,26
2800599,04/02/24,Chelsea,30,12,7,19,6,5,60,31,29,63
2800599,04/02/24,Liverpool,30,8,8,16,6,8,54,32,22,54
2800599,04/02/24,Tottenham,30,7,5,12,6,12,49,45,4,42
2800599,04/02/24,Manchester Blue,30,10,5,15,9,6,54,35,19,54
2800599,04/02/24,Bournemouth,30,6,7,13,10,7,41,32,9,49
2800599,04/02/24,West Ham,30,6,4,10,7,13,30,41,-11,37
2800599,04/02/24,Manchester Reds,30,8,4,12,9,9,44,42,2,45
2800599,04/02/24,Wolverhampton,30,8,5,13,6,11,30,27,3,45
2800599,04/02/24,Watford,30,4,7,11,4,15,36,44,-8,37
2800599,04/02/24,London Guns,30,7,7,14,8,8,48,39,9,50
2800599,04/02/24,Everton,30,5,3,8,9,13,36,45,-9,33
2800599,04/02/24,Burnley,30,7,4,11,7,12,31,36,-5,40
2800599,04/02/24,Southampton,30,6,2,8,6,16,30,51,-21,30
2800599,04/02/24,Leicester,30,5,3,8,7,15,38,51,-13,31
2800599,04/02/24,Crystal Palace,30,3,2,5,10,15,29,42,-13,25
2800599,04/02/24,Newcastle,30,6,1,7,6,17,25,42,-17,27
2800624,04/02/24,Chelsea,30,8,9,17,4,9,51,29,22,55
2800624,04/02/24,Liverpool,30,11,4,15,6,9,45,32,13,51
2800624,04/02/24,Tottenham,30,9,5,14,3,13,46,37,9,45
2800624,04/02/24,Manchester Blue,30,12,9,21,1,8,69,38,31,64
2800624,04/02/24,Bournemouth,30,7,6,13,7,10,43,33,10,46
2800624,04/02/24,West Ham,30,6,3,9,5,16,31,48,-17,32
2800624,04/02/24,Manchester Reds,30,7,6,13,8,9,43,39,4,47
2800624,04/02/24,Wolverhampton,30,4,5,9,4,17,29,37,-8,31
2800624,04/02/24,Watford,30,7,3,10,6,14,38,43,-5,36
2800624,04/02/24,London Guns,30,11,7,18,8,4,57,33,24,62
2800624,04/02/24,Everton,30,8,5,13,6,11,38,38,0,45
2800624,04/02/24,Burnley,30,2,4,6,10,14,20,35,-15,28
2800624,04/02/24,Southampton,30,5,2,7,5,18,25,58,-33,26
2800624,04/02/24,Leicester,30,7,7,14,4,12,38,31,7,46
2800624,04/02/24,Crystal Palace,30,5,4,9,7,14,34,54,-20,34
2800624,04/02/24,Newcastle,30,6,1,7,6,17,30,52,-22,27
2800650,04/02/24,Chelsea,30,7,6,13,8,9,46,35,11,47
2800650,04/02/24,Liverpool,30,11,10,21,7,2,55,17,38,70
2800650,04/02/24,Tottenham,30,7,4,11,8,11,42,40,2,41
2800650,04/02/24,Manchester Blue,30,11,9,20,7,3,68,23,45,67
2800650,04/02/24,Bournemouth,30,5,5,10,10,10,31,20,11,40
2800650,04/02/24,West Ham,30,2,1,3,10,17,17,45,-28,19
2800650,04/02/24,Manchester Reds,30,9,5,14,10,6,46,30,16,52
2800650,04/02/24,Wolverhampton,30,5,2,7,12,11,27,32,-5,33
2800650,04/02/24,Watford,30,5,7,12,4,14,36,46,-10,40
2800650,04/02/24,London Guns,30,7,5,12,9,9,52,44,8,45
2800650,04/02/24,Everton,30,4,5,9,10,11,29,35,-6,37
2800650,04/02/24,Burnley,30,5,4,9,10,11,26,35,-9,37
2800650,04/02/24,Southampton,30,8,6,14,6,10,41,38,3,48
2800650,04/02/24,Leicester,30,5,3,8,5,17,34,56,-22,29
2800650,04/02/24,Crystal Palace,30,3,3,6,10,14,32,45,-13,28
2800650,04/02/24,Newcastle,30,3,3,6,4,20,30,71,-41,22
2800674,04/02/24,Chelsea,30,9,5,14,9,7,39,28,11,51
2800674,04/02/24,Liverpool,30,11,4,15,6,9,50,28,22,51
2800674,04/02/24,Tottenham,30,8,6,14,8,8,48,39,9,50
2800674,04/02/24,Manchester Blue,30,7,7,14,8,8,50,37,13,50
2800674,04/02/24,Bournemouth,30,7,6,13,9,8,41,28,13,48
2800674,04/02/24,West Ham,30,5,2,7,7,16,26,44,-18,28
2800674,04/02/24,Manchester Reds,30,8,7,15,9,6,46,33,13,54
2800674,04/02/24,Wolverhampton,30,9,3,12,9,9,28,25,3,45
2800674,04/02/24,Watford,30,7,1,8,6,16,34,45,-11,30
2800674,04/02/24,London Guns,30,12,7,19,4,7,69,36,33,61
2800674,04/02/24,Everton,30,4,4,8,8,14,39,53,-14,32
2800674,04/02/24,Burnley,30,6,3,9,11,10,19,32,-13,38
2800674,04/02/24,Southampton,30,4,3,7,8,15,27,51,-24,29
2800674,04/02/24,Leicester,30,7,4,11,9,10,40,40,0,42
2800674,04/02/24,Crystal Palace,30,3,2,5,9,16,29,46,-17,24
2800674,04/02/24,Newcastle,30,4,2,6,6,18,22,42,-20,24
2800701,04/02/24,Chelsea,30,12,7,19,5,6,57,31,26,62
2800701,04/02/24,Liverpool,30,9,7,16,5,9,50,28,22,53
2800701,04/02/24,Tottenham,30,10,6,16,7,7,49,40,9,55
2800701,04/02/24,Manchester Blue,30,10,7,17,6,7,54,39,15,57
2800701,04/02/24,Bournemouth,30,6,7,13,9,8,40,32,8,48
2800701,04/02/24,West Ham,30,6,1,7,7,16,35,53,-18,28
2800701,04/02/24,Manchester Reds,30,10,7,17,7,6,55,30,25,58
2800701,04/02/24,Wolverhampton,30,6,4,10,9,11,30,34,-4,39
2800701,04/02/24,Watford,30,7,5,12,6,12,42,41,1,42
2800701,04/02/24,London Guns,30,10,4,14,3,13,51,43,8,45
2800701,04/02/24,Everton,30,5,7,12,2,16,48,51,-3,38
2800701,04/02/24,Burnley,30,4,3,7,10,13,26,35,-9,31
2800701,04/02/24,Southampton,30,4,6,10,2,18,23,48,-25,32
2800701,04/02/24,Leicester,30,5,3,8,5,17,37,56,-19,29
2800701,04/02/24,Crystal Palace,30,7,4,11,7,12,36,42,-6,40
2800701,04/02/24,Newcastle,30,2,0,2,8,20,22,52,-30,14
2800726,05/02/24,Chelsea,30,6,6,12,10,8,43,29,14,46
2800726,05/02/24,Liverpool,30,7,9,16,7,7,60,38,22,55
2800726,05/02/24,Tottenham,30,5,6,11,8,11,45,41,4,41
2800726,05/02/24,Manchester Blue,30,12,9,21,5,4,64,32,32,68
2800726,05/02/24,Bournemouth,30,10,6,16,3,11,47,32,15,51
2800726,05/02/24,West Ham,30,5,4,9,10,11,33,37,-4,37
2800726,05/02/24,Manchester Reds,30,9,6,15,6,9,44,30,14,51
2800726,05/02/24,Wolverhampton,30,8,7,15,4,11,32,26,6,49
2800726,05/02/24,Watford,30,3,4,7,6,17,18,44,-26,27
2800726,05/02/24,London Guns,30,11,5,16,8,6,56,29,27,56
2800726,05/02/24,Everton,30,5,4,9,7,14,40,53,-13,34
2800726,05/02/24,Burnley,30,5,6,11,6,13,30,42,-12,39
2800726,05/02/24,Southampton,30,5,5,10,3,17,25,44,-19,33
2800726,05/02/24,Leicester,30,5,4,9,6,15,38,44,-6,33
2800726,05/02/24,Crystal Palace,30,1,2,3,7,20,16,56,-40,16
2800726,05/02/24,Newcastle,30,4,4,8,8,14,25,39,-14,32
2800753,05/02/24,Chelsea,30,9,7,16,6,8,41,23,18,54
2800753,05/02/24,Liverpool,30,8,5,13,11,6,45,32,13,50
2800753,05/02/24,Tottenham,30,9,7,16,6,8,49,26,23,54
2800753,05/02/24,Manchester Blue,30,10,9,19,7,4,60,22,38,64
2800753,05/02/24,Bournemouth,30,10,8,18,5,7,44,29,15,59
2800753,05/02/24,West Ham,30,6,3,9,4,17,20,44,-24,31
2800753,05/02/24,Manchester Reds,30,7,4,11,6,13,35,37,-2,39
2800753,05/02/24,Wolverhampton,30,6,6,12,8,10,26,27,-1,44
2800753,05/02/24,Watford,30,7,6,13,4,13,39,40,-1,43
2800753,05/02/24,London Guns,30,5,8,13,10,7,49,37,12,49
2800753,05/02/24,Everton,30,2,4,6,9,15,31,39,-8,27
2800753,05/02/24,Burnley,30,4,3,7,5,18,20,36,-16,26
2800753,05/02/24,Southampton,30,2,4,6,7,17,22,50,-28,25
2800753,05/02/24,Leicester,30,7,4,11,4,15,35,42,-7,37
2800753,05/02/24,Crystal Palace,30,7,2,9,9,12,29,43,-14,36
2800753,05/02/24,Newcastle,30,4,3,7,7,16,26,44,-18,28
2800776,05/02/24,Chelsea,30,6,3,9,13,8,45,39,6,40
2800776,05/02/24,Liverpool,30,7,9,16,7,7,50,30,20,55
2800776,05/02/24,Tottenham,30,8,9,17,6,7,58,35,23,57
2800776,05/02/24,Manchester Blue,30,10,7,17,8,5,62,35,27,59
2800776,05/02/24,Bournemouth,30,10,3,13,7,10,40,33,7,46
2800776,05/02/24,West Ham,30,6,5,11,7,12,37,48,-11,40
2800776,05/02/24,Manchester Reds,30,7,4,11,10,9,33,37,-4,43
2800776,05/02/24,Wolverhampton,30,5,7,12,8,10,34,31,3,44
2800776,05/02/24,Watford,30,4,2,6,10,14,25,42,-17,28
2800776,05/02/24,London Guns,30,10,7,17,8,5,65,32,33,59
2800776,05/02/24,Everton,30,1,6,7,8,15,39,52,-13,29
2800776,05/02/24,Burnley,30,3,5,8,9,13,24,35,-11,33
2800776,05/02/24,Southampton,30,2,3,5,9,16,18,40,-22,24
2800776,05/02/24,Leicester,30,6,4,10,6,14,37,48,-11,36
2800776,05/02/24,Crystal Palace,30,5,2,7,8,15,25,45,-20,29
2800776,05/02/24,Newcastle,30,3,4,7,10,13,32,42,-10,31
2800803,05/02/24,Chelsea,30,10,7,17,8,5,52,26,26,59
2800803,05/02/24,Liverpool,30,9,8,17,7,6,44,21,23,58
2800803,05/02/24,Tottenham,30,5,4,9,11,10,35,35,0,38
2800803,05/02/24,Manchester Blue,30,9,8,17,4,9,61,29,32,55
2800803,05/02/24,Bournemouth,30,9,6,15,7,8,32,20,12,52
2800803,05/02/24,West Ham,30,6,5,11,7,12,32,35,-3,40
2800803,05/02/24,Manchester Reds,30,6,5,11,9,10,33,26,7,42
2800803,05/02/24,Wolverhampton,30,6,4,10,9,11,27,32,-5,39
2800803,05/02/24,Watford,30,3,4,7,10,13,29,42,-13,31
2800803,05/02/24,London Guns,30,8,6,14,10,6,46,32,14,52
2800803,05/02/24,Everton,30,6,4,10,7,13,37,44,-7,37
2800803,05/02/24,Burnley,30,8,2,10,8,12,26,33,-7,38
2800803,05/02/24,Southampton,30,3,2,5,7,18,15,37,-22,22
2800803,05/02/24,Leicester,30,8,5,13,4,13,44,54,-10,43
2800803,05/02/24,Crystal Palace,30,5,3,8,6,16,26,44,-18,30
2800803,05/02/24,Newcastle,30,2,3,5,8,17,24,53,-29,23
2800828,05/02/24,Chelsea,30,8,6,14,8,8,44,32,12,50
2800828,05/02/24,Liverpool,30,10,12,22,4,4,56,22,34,70
2800828,05/02/24,Tottenham,30,7,5,12,8,10,38,33,5,44
2800828,05/02/24,Manchester Blue,30,11,8,19,3,8,49,31,18,60
2800828,05/02/24,Bournemouth,30,7,6,13,9,8,43,34,9,48
2800828,05/02/24,West Ham,30,6,2,8,2,20,20,41,-21,26
2800828,05/02/24,Manchester Reds,30,6,3,9,5,16,34,38,-4,32
2800828,05/02/24,Wolverhampton,30,8,4,12,7,11,33,44,-11,43
2800828,05/02/24,Watford,30,4,7,11,5,14,44,45,-1,38
2800828,05/02/24,London Guns,30,10,7,17,4,9,50,28,22,55
2800828,05/02/24,Everton,30,9,8,17,5,8,47,31,16,56
2800828,05/02/24,Burnley,30,3,3,6,9,15,26,44,-18,27
2800828,05/02/24,Southampton,30,4,3,7,13,10,30,34,-4,34
2800828,05/02/24,Leicester,30,7,6,13,5,12,50,47,3,44
2800828,05/02/24,Crystal Palace,30,4,2,6,3,21,26,57,-31,21
2800828,05/02/24,Newcastle,30,4,2,6,6,18,20,49,-29,24
2800855,05/02/24,Chelsea,30,9,8,17,5,8,47,28,19,56
2800855,05/02/24,Liverpool,30,10,7,17,5,8,54,28,26,56
2800855,05/02/24,Tottenham,30,7,4,11,8,11,40,38,2,41
2800855,05/02/24,Manchester Blue,30,10,6,16,7,7,52,29,23,55
2800855,05/02/24,Bournemouth,30,4,6,10,9,11,29,25,4,39
2800855,05/02/24,West Ham,30,5,2,7,6,17,26,50,-24,27
2800855,05/02/24,Manchester Reds,30,7,9,16,5,9,43,30,13,53
2800855,05/02/24,Wolverhampton,30,10,6,16,6,8,34,23,11,54
2800855,05/02/24,Watford,30,6,5,11,9,10,41,40,1,42
2800855,05/02/24,London Guns,30,11,4,15,8,7,50,34,16,53
2800855,05/02/24,Everton,30,5,5,10,7,13,36,45,-9,37
2800855,05/02/24,Burnley,30,4,6,10,6,14,26,40,-14,36
2800855,05/02/24,Southampton,30,4,4,8,11,11,33,40,-7,35
2800855,05/02/24,Leicester,30,7,2,9,5,16,38,48,-10,32
2800855,05/02/24,Crystal Palace,30,5,3,8,6,16,26,46,-20,30
2800855,05/02/24,Newcastle,30,4,2,6,3,21,22,53,-31,21
2800881,05/02/24,Chelsea,30,8,6,14,6,10,44,28,16,48
2800881,05/02/24,Liverpool,30,7,9,16,6,8,41,20,21,54
2800881,05/02/24,Tottenham,30,8,5,13,9,8,56,46,10,48
2800881,05/02/24,Manchester Blue,30,9,5,14,10,6,53,36,17,52
2800881,05/02/24,Bournemouth,30,11,5,16,6,8,46,24,22,54
2800881,05/02/24,West Ham,30,5,4,9,4,17,34,56,-22,31
2800881,05/02/24,Manchester Reds,30,7,7,14,6,10,48,37,11,48
2800881,05/02/24,Wolverhampton,30,7,6,13,11,6,37,31,6,50
2800881,05/02/24,Watford,30,8,1,9,10,11,37,34,3,37
2800881,05/02/24,London Guns,30,12,5,17,5,8,55,37,18,56
2800881,05/02/24,Everton,30,9,4,13,5,12,43,41,2,44
2800881,05/02/24,Burnley,30,2,3,5,9,16,20,43,-23,24
2800881,05/02/24,Southampton,30,2,1,3,12,15,19,46,-27,21
2800881,05/02/24,Leicester,30,4,3,7,10,13,27,41,-14,31
2800881,05/02/24,Crystal Palace,30,3,4,7,12,11,33,45,-12,33
2800881,05/02/24,Newcastle,30,4,2,6,7,17,25,53,-28,25
2800908,05/02/24,Chelsea,30,11,7,18,9,3,61,27,34,63
2800908,05/02/24,Liverpool,30,4,6,10,8,12,49,37,12,38
2800908,05/02/24,Tottenham,30,6,8,14,11,5,53,37,16,53
2800908,05/02/24,Manchester Blue,30,13,9,22,6,2,72,25,47,72
2800908,05/02/24,Bournemouth,30,6,5,11,8,11,30,38,-8,41
2800908,05/02/24,West Ham,30,6,1,7,10,13,34,46,-12,31
2800908,05/02/24,Manchester Reds,30,10,4,14,9,7,43,27,16,51
2800908,05/02/24,Wolverhampton,30,6,5,11,6,13,27,34,-7,39
2800908,05/02/24,Watford,30,8,2,10,7,13,42,39,3,37
2800908,05/02/24,London Guns,30,10,7,17,7,6,54,36,18,58
2800908,05/02/24,Everton,30,7,5,12,6,12,39,35,4,42
2800908,05/02/24,Burnley,30,3,4,7,10,13,17,37,-20,31
2800908,05/02/24,Southampton,30,4,4,8,8,14,21,37,-16,32
2800908,05/02/24,Leicester,30,4,4,8,9,13,38,47,-9,33
2800908,05/02/24,Crystal Palace,30,2,2,4,7,19,12,45,-33,19
2800908,05/02/24,Newcastle,30,2,2,4,5,21,19,64,-45,17
2800931,05/02/24,Chelsea,30,8,6,14,9,7,52,30,22,51
2800931,05/02/24,Liverpool,30,10,4,14,6,10,49,28,21,48
2800931,05/02/24,Tottenham,30,8,9,17,5,8,54,37,17,56
2800931,05/02/24,Manchester Blue,30,10,7,17,5,8,56,34,22,56
2800931,05/02/24,Bournemouth,30,8,8,16,6,8,36,19,17,54
2800931,05/02/24,West Ham,30,7,3,10,7,13,35,46,-11,37
2800931,05/02/24,Manchester Reds,30,8,6,14,8,8,51,36,15,50
2800931,05/02/24,Wolverhampton,30,6,5,11,5,14,30,36,-6,38
2800931,05/02/24,Watford,30,7,5,12,6,12,38,32,6,42
2800931,05/02/24,London Guns,30,9,5,14,6,10,58,44,14,48
2800931,05/02/24,Everton,30,7,5,12,7,11,41,41,0,43
2800931,05/02/24,Burnley,30,3,3,6,9,15,21,39,-18,27
2800931,05/02/24,Southampton,30,6,2,8,7,15,25,47,-22,31
2800931,05/02/24,Leicester,30,6,3,9,6,15,24,56,-32,33
2800931,05/02/24,Crystal Palace,30,5,4,9,7,14,36,48,-12,34
2800931,05/02/24,Newcastle,30,3,2,5,5,20,25,58,-33,20
2800959,05/02/24,Chelsea,30,11,6,17,8,5,55,30,25,59
2800959,05/02/24,Liverpool,30,11,4,15,7,8,46,23,23,52
2800959,05/02/24,Tottenham,30,7,2,9,9,12,44,40,4,36
2800959,05/02/24,Manchester Blue,30,6,6,12,11,7,54,41,13,47
2800959,05/02/24,Bournemouth,30,7,5,12,10,8,41,35,6,46
2800959,05/02/24,West Ham,30,7,5,12,8,10,35,37,-2,44
2800959,05/02/24,Manchester Reds,30,10,5,15,7,8,41,33,8,52
2800959,05/02/24,Wolverhampton,30,6,5,11,8,11,31,30,1,41
2800959,05/02/24,Watford,30,6,4,10,5,15,37,53,-16,35
2800959,05/02/24,London Guns,30,11,5,16,6,8,48,35,13,54
2800959,05/02/24,Everton,30,5,3,8,9,13,43,51,-8,33
2800959,05/02/24,Burnley,30,3,5,8,12,10,32,32,0,36
2800959,05/02/24,Southampton,30,3,5,8,6,16,28,42,-14,30
2800959,05/02/24,Leicester,30,5,3,8,6,16,31,59,-28,30
2800959,05/02/24,Crystal Palace,30,4,5,9,7,14,29,37,-8,34
2800959,05/02/24,Newcastle,30,3,3,6,9,15,24,41,-17,27
2800980,05/02/24,Chelsea,30,8,7,15,7,8,45,29,16,52
2800980,05/02/24,Liverpool,30,10,9,19,7,4,51,18,33,64
2800980,05/02/24,Tottenham,30,7,5,12,8,10,41,36,5,44
2800980,05/02/24,Manchester Blue,30,10,10,20,5,5,60,27,33,65
2800980,05/02/24,Bournemouth,30,7,6,13,8,9,40,30,10,47
2800980,05/02/24,West Ham,30,6,3,9,10,11,32,41,-9,37
2800980,05/02/24,Manchester Reds,30,7,3,10,12,8,45,32,13,42
2800980,05/02/24,Wolverhampton,30,6,3,9,6,15,31,41,-10,33
2800980,05/02/24,Watford,30,5,2,7,7,16,36,39,-3,28
2800980,05/02/24,London Guns,30,8,6,14,7,9,47,38,9,49
2800980,05/02/24,Everton,30,10,4,14,8,8,50,38,12,50
2800980,05/02/24,Burnley,30,3,3,6,8,16,21,42,-21,26
2800980,05/02/24,Southampton,30,2,0,2,8,20,13,47,-34,14
2800980,05/02/24,Leicester,30,5,4,9,7,14,39,58,-19,34
2800980,05/02/24,Crystal Palace,30,5,4,9,5,16,26,54,-28,32
2800980,05/02/24,Newcastle,30,10,3,13,5,12,34,41,-7,44
2801006,05/02/24,Chelsea,30,9,5,14,8,8,44,30,14,50
2801006,05/02/24,Liverpool,30,10,9,19,10,1,59,22,37,67
2801006,05/02/24,Tottenham,30,7,2,9,12,9,33,33,0,39
2801006,05/02/24,Manchester Blue,30,10,9,19,6,5,50,26,24,63
2801006,05/02/24,Bournemouth,30,8,5,13,9,8,40,29,11,48
2801006,05/02/24,West Ham,30,5,4,9,4,17,26,46,-20,31
2801006,05/02/24,Manchester Reds,30,9,6,15,8,7,44,32,12,53
2801006,05/02/24,Wolverhampton,30,7,1,8,5,17,21,37,-16,29
2801006,05/02/24,Watford,30,8,2,10,10,10,40,38,2,40
2801006,05/02/24,London Guns,30,8,11,19,3,8,50,26,24,60
2801006,05/02/24,Everton,30,4,5,9,8,13,36,42,-6,35
2801006,05/02/24,Burnley,30,2,6,8,7,15,28,40,-12,31
2801006,05/02/24,Southampton,30,2,3,5,8,17,17,37,-20,23
2801006,05/02/24,Leicester,30,3,3,6,8,16,24,44,-20,26
2801006,05/02/24,Crystal Palace,30,5,4,9,6,15,31,44,-13,33
2801006,05/02/24,Newcastle,30,4,4,8,8,14,25,42,-17,32
2801033,06/02/24,Chelsea,30,7,11,18,4,8,53,32,21,58
2801033,06/02/24,Liverpool,30,8,8,16,8,6,43,21,22,56
2801033,06/02/24,Tottenham,30,6,4,10,11,9,33,37,-4,41
2801033,06/02/24,Manchester Blue,30,10,7,17,5,8,51,28,23,56
2801033,06/02/24,Bournemouth,30,10,6,16,2,12,41,36,5,50
2801033,06/02/24,West Ham,30,6,4,10,3,17,37,48,-11,33
2801033,06/02/24,Manchester Reds,30,9,6,15,4,11,47,34,13,49
2801033,06/02/24,Wolverhampton,30,7,4,11,7,12,32,41,-9,40
2801033,06/02/24,Watford,30,5,5,10,5,15,30,36,-6,35
2801033,06/02/24,London Guns,30,9,7,16,7,7,57,33,24,55
2801033,06/02/24,Everton,30,9,6,15,3,12,42,42,0,48
2801033,06/02/24,Burnley,30,3,2,5,8,17,24,44,-20,23
2801033,06/02/24,Southampton,30,4,3,7,7,16,22,38,-16,28
2801033,06/02/24,Leicester,30,3,5,8,7,15,32,49,-17,31
2801033,06/02/24,Crystal Palace,30,3,5,8,8,14,29,45,-16,32
2801033,06/02/24,Newcastle,30,7,4,11,5,14,33,42,-9,38
2801061,06/02/24,Chelsea,30,9,9,18,7,5,51,20,31,61
2801061,06/02/24,Liverpool,30,10,6,16,9,5,56,30,26,57
2801061,06/02/24,Tottenham,30,8,5,13,7,10,56,37,19,46
2801061,06/02/24,Manchester Blue,30,10,9,19,3,8,51,26,25,60
2801061,06/02/24,Bournemouth,30,10,2,12,11,7,44,34,10,47
2801061,06/02/24,West Ham,30,6,3,9,10,11,36,42,-6,37
2801061,06/02/24,Manchester Reds,30,9,5,14,9,7,46,26,20,51
2801061,06/02/24,Wolverhampton,30,6,4,10,6,14,25,37,-12,36
2801061,06/02/24,Watford,30,8,2,10,6,14,30,44,-14,36
2801061,06/02/24,London Guns,30,6,7,13,12,5,53,39,14,51
2801061,06/02/24,Everton,30,6,2,8,7,15,38,47,-9,31
2801061,06/02/24,Burnley,30,5,3,8,6,16,26,46,-20,30
2801061,06/02/24,Southampton,30,6,1,7,6,17,18,41,-23,27
2801061,06/02/24,Leicester,30,7,1,8,7,15,45,58,-13,31
2801061,06/02/24,Crystal Palace,30,6,3,9,5,16,34,56,-22,32
2801061,06/02/24,Newcastle,30,5,2,7,7,16,25,51,-26,28
2801086,06/02/24,Chelsea,30,12,8,20,8,2,73,26,47,68
2801086,06/02/24,Liverpool,30,10,6,16,8,6,56,31,25,56
2801086,06/02/24,Tottenham,30,9,7,16,3,11,55,38,17,51
2801086,06/02/24,Manchester Blue,30,8,10,18,9,3,53,33,20,63
2801086,06/02/24,Bournemouth,30,4,5,9,9,12,29,36,-7,36
2801086,06/02/24,West Ham,30,4,4,8,10,12,29,39,-10,34
2801086,06/02/24,Manchester Reds,30,9,4,13,9,8,49,34,15,48
2801086,06/02/24,Wolverhampton,30,6,4,10,7,13,30,38,-8,37
2801086,06/02/24,Watford,30,8,4,12,8,10,35,38,-3,44
2801086,06/02/24,London Guns,30,10,3,13,7,10,53,41,12,46
2801086,06/02/24,Everton,30,7,4,11,7,12,42,41,1,40
2801086,06/02/24,Burnley,30,4,2,6,8,16,20,40,-20,26
2801086,06/02/24,Southampton,30,3,2,5,8,17,21,46,-25,23
2801086,06/02/24,Leicester,30,4,4,8,10,12,31,48,-17,34
2801086,06/02/24,Crystal Palace,30,3,4,7,8,15,25,52,-27,29
2801086,06/02/24,Newcastle,30,3,1,4,9,17,23,43,-20,21
2801112,06/02/24,Chelsea,30,7,7,14,6,10,44,35,9,48
2801112,06/02/24,Liverpool,30,9,6,15,7,8,46,27,19,52
2801112,06/02/24,Tottenham,30,12,6,18,7,5,51,29,22,61
2801112,06/02/24,Manchester Blue,30,5,8,13,10,7,52,32,20,49
2801112,06/02/24,Bournemouth,30,5,7,12,10,8,40,37,3,46
2801112,06/02/24,West Ham,30,8,3,11,8,11,41,44,-3,41
2801112,06/02/24,Manchester Reds,30,6,7,13,11,6,55,38,17,50
2801112,06/02/24,Wolverhampton,30,7,3,10,10,10,31,34,-3,40
2801112,06/02/24,Watford,30,8,2,10,5,15,34,44,-10,35
2801112,06/02/24,London Guns,30,7,5,12,5,13,44,42,2,41
2801112,06/02/24,Everton,30,4,4,8,9,13,38,48,-10,33
2801112,06/02/24,Burnley,30,4,3,7,8,15,32,38,-6,29
2801112,06/02/24,Southampton,30,3,3,6,4,20,19,46,-27,22
2801112,06/02/24,Leicester,30,7,5,12,8,10,40,43,-3,44
2801112,06/02/24,Crystal Palace,30,6,4,10,6,14,39,55,-16,36
2801112,06/02/24,Newcastle,30,6,3,9,6,15,34,48,-14,33
2801137,06/02/24,Chelsea,30,9,7,16,7,7,55,32,23,55
2801137,06/02/24,Liverpool,30,11,7,18,5,7,61,30,31,59
2801137,06/02/24,Tottenham,30,7,7,14,7,9,48,35,13,49
2801137,06/02/24,Manchester Blue,30,10,7,17,10,3,58,27,31,61
2801137,06/02/24,Bournemouth,30,10,6,16,5,9,45,29,16,53
2801137,06/02/24,West Ham,30,4,4,8,6,16,24,47,-23,30
2801137,06/02/24,Manchester Reds,30,6,5,11,12,7,35,35,0,45
2801137,06/02/24,Wolverhampton,30,7,5,12,9,9,35,25,10,45
2801137,06/02/24,Watford,30,5,2,7,7,16,29,46,-17,28
2801137,06/02/24,London Guns,30,8,4,12,10,8,48,37,11,46
2801137,06/02/24,Everton,30,4,5,9,6,15,41,51,-10,33
2801137,06/02/24,Burnley,30,6,3,9,7,14,23,44,-21,34
2801137,06/02/24,Southampton,30,6,0,6,8,16,28,51,-23,26
2801137,06/02/24,Leicester,30,3,4,7,11,12,38,50,-12,32
2801137,06/02/24,Crystal Palace,30,6,4,10,8,12,38,48,-10,38
2801137,06/02/24,Newcastle,30,4,1,5,8,17,32,51,-19,23
2801163,06/02/24,Chelsea,30,7,9,16,5,9,43,25,18,53
2801163,06/02/24,Liverpool,30,7,6,13,12,5,42,26,16,51
2801163,06/02/24,Tottenham,30,7,7,14,8,8,47,36,11,50
2801163,06/02/24,Manchester Blue,30,8,7,15,6,9,57,33,24,51
2801163,06/02/24,Bournemouth,30,6,3,9,10,11,31,31,0,37
2801163,06/02/24,West Ham,30,3,3,6,9,15,38,54,-16,27
2801163,06/02/24,Manchester Reds,30,8,3,11,9,10,43,37,6,42
2801163,06/02/24,Wolverhampton,30,7,4,11,9,10,21,20,1,42
2801163,06/02/24,Watford,30,8,5,13,10,7,45,35,10,49
2801163,06/02/24,London Guns,30,8,6,14,9,7,53,36,17,51
2801163,06/02/24,Everton,30,7,5,12,6,12,35,41,-6,42
2801163,06/02/24,Burnley,30,3,2,5,14,11,20,29,-9,29
2801163,06/02/24,Southampton,30,5,3,8,8,14,35,50,-15,32
2801163,06/02/24,Leicester,30,5,5,10,11,9,38,44,-6,41
2801163,06/02/24,Crystal Palace,30,3,2,5,10,15,27,60,-33,25
2801163,06/02/24,Newcastle,30,5,1,6,8,16,25,43,-18,26
2801190,06/02/24,Chelsea,30,12,8,20,4,6,58,27,31,64
2801190,06/02/24,Liverpool,30,11,5,16,9,5,53,27,26,57
2801190,06/02/24,Tottenham,30,8,8,16,6,8,47,28,19,54
2801190,06/02/24,Manchester Blue,30,7,12,19,6,5,63,40,23,63
2801190,06/02/24,Bournemouth,30,7,6,13,8,9,36,27,9,47
2801190,06/02/24,West Ham,30,3,3,6,9,15,31,52,-21,27
2801190,06/02/24,Manchester Reds,30,7,4,11,8,11,48,48,0,41
2801190,06/02/24,Wolverhampton,30,10,3,13,7,10,36,33,3,46
2801190,06/02/24,Watford,30,5,4,9,7,14,30,46,-16,34
2801190,06/02/24,London Guns,30,9,9,18,4,8,63,34,29,58
2801190,06/02/24,Everton,30,1,6,7,11,12,33,44,-11,32
2801190,06/02/24,Burnley,30,4,0,4,11,15,20,42,-22,23
2801190,06/02/24,Southampton,30,4,3,7,9,14,29,46,-17,30
2801190,06/02/24,Leicester,30,5,8,13,8,9,47,43,4,47
2801190,06/02/24,Crystal Palace,30,5,2,7,4,19,35,55,-20,25
2801190,06/02/24,Newcastle,30,2,2,4,3,23,17,54,-37,15
2801216,06/02/24,Chelsea,30,12,6,18,7,5,51,25,26,61
2801216,06/02/24,Liverpool,30,9,10,19,3,8,64,28,36,60
2801216,06/02/24,Tottenham,30,7,7,14,6,10,47,38,9,48
2801216,06/02/24,Manchester Blue,30,11,7,18,4,8,57,33,24,58
2801216,06/02/24,Bournemouth,30,9,5,14,9,7,40,28,12,51
2801216,06/02/24,West Ham,30,5,1,6,12,12,32,48,-16,30
2801216,06/02/24,Manchester Reds,30,5,3,8,13,9,32,34,-2,37
2801216,06/02/24,Wolverhampton,30,4,4,8,10,12,36,57,-21,34
2801216,06/02/24,Watford,30,6,3,9,10,11,31,35,-4,37
2801216,06/02/24,London Guns,30,10,7,17,7,6,58,39,19,58
2801216,06/02/24,Everton,30,4,4,8,10,12,29,38,-9,34
2801216,06/02/24,Burnley,30,7,4,11,6,13,33,37,-4,39
2801216,06/02/24,Southampton,30,4,2,6,9,15,17,40,-23,27
2801216,06/02/24,Leicester,30,6,3,9,10,11,43,48,-5,37
2801216,06/02/24,Crystal Palace,30,4,1,5,7,18,25,50,-25,22
2801216,06/02/24,Newcastle,30,5,0,5,7,18,24,41,-17,22
2801243,06/02/24,Chelsea,30,12,10,22,3,5,55,23,32,69
2801243,06/02/24,Liverpool,30,6,10,16,9,5,47,26,21,57
2801243,06/02/24,Tottenham,30,9,5,14,4,12,52,42,10,46
2801243,06/02/24,Manchester Blue,30,11,6,17,7,6,58,31,27,58
2801243,06/02/24,Bournemouth,30,7,5,12,9,9,33,31,2,45
2801243,06/02/24,West Ham,30,3,3,6,11,13,27,48,-21,29
2801243,06/02/24,Manchester Reds,30,10,5,15,9,6,48,37,11,54
2801243,06/02/24,Wolverhampton,30,8,4,12,6,12,29,32,-3,42
2801243,06/02/24,Watford,30,5,5,10,5,15,34,41,-7,35
2801243,06/02/24,London Guns,30,6,6,12,8,10,42,33,9,44
2801243,06/02/24,Everton,30,6,4,10,8,12,32,32,0,38
2801243,06/02/24,Burnley,30,5,6,11,4,15,30,37,-7,37
2801243,06/02/24,Southampton,30,2,1,3,8,19,17,45,-28,17
2801243,06/02/24,Leicester,30,5,6,11,3,16,37,50,-13,36
2801243,06/02/24,Crystal Palace,30,6,4,10,5,15,28,40,-12,35
2801243,06/02/24,Newcastle,30,5,2,7,5,18,27,48,-21,26
2801269,06/02/24,Chelsea,30,10,7,17,9,4,46,25,21,60
2801269,06/02/24,Liverpool,30,10,6,16,8,6,51,32,19,56
2801269,06/02/24,Tottenham,30,9,5,14,3,13,51,45,6,45
2801269,06/02/24,Manchester Blue,30,7,9,16,5,9,54,28,26,53
2801269,06/02/24,Bournemouth,30,6,7,13,7,10,38,33,5,46
2801269,06/02/24,West Ham,30,6,2,8,11,11,27,36,-9,35
2801269,06/02/24,Manchester Reds,30,8,4,12,8,10,40,36,4,44
2801269,06/02/24,Wolverhampton,30,7,4,11,8,11,39,32,7,41
2801269,06/02/24,Watford,30,9,4,13,8,9,37,32,5,47
2801269,06/02/24,London Guns,30,8,7,15,7,8,43,36,7,52
2801269,06/02/24,Everton,30,5,3,8,13,9,39,38,1,37
2801269,06/02/24,Burnley,30,4,5,9,10,11,32,35,-3,37
2801269,06/02/24,Southampton,30,1,2,3,10,17,18,50,-32,19
2801269,06/02/24,Leicester,30,5,3,8,11,11,41,35,6,35
2801269,06/02/24,Crystal Palace,30,3,2,5,9,16,26,57,-31,24
2801269,06/02/24,Newcastle,30,3,3,6,5,19,26,58,-32,23
2801294,06/02/24,Chelsea,30,9,6,15,6,9,52,29,23,51
2801294,06/02/24,Liverpool,30,7,6,13,7,10,42,34,8,46
2801294,06/02/24,Tottenham,30,6,7,13,8,9,51,40,11,47
2801294,06/02/24,Manchester Blue,30,8,8,16,6,8,53,27,26,54
2801294,06/02/24,Bournemouth,30,7,7,14,10,6,34,20,14,52
2801294,06/02/24,West Ham,30,4,2,6,7,17,25,46,-21,25
2801294,06/02/24,Manchester Reds,30,11,7,18,4,8,45,33,12,58
2801294,06/02/24,Wolverhampton,30,8,7,15,4,11,32,30,2,49
2801294,06/02/24,Watford,30,8,6,14,6,10,38,39,-1,48
2801294,06/02/24,London Guns,30,11,7,18,7,5,69,31,38,61
2801294,06/02/24,Everton,30,5,3,8,9,13,28,38,-10,33
2801294,06/02/24,Burnley,30,5,3,8,8,14,25,34,-9,32
2801294,06/02/24,Southampton,30,4,2,6,6,18,26,47,-21,24
2801294,06/02/24,Leicester,30,4,4,8,10,12,22,43,-21,34
2801294,06/02/24,Crystal Palace,30,3,5,8,4,18,35,56,-21,28
2801294,06/02/24,Newcastle,30,2,4,6,6,18,26,56,-30,24
2801318,06/02/24,Chelsea,30,11,8,19,7,4,55,23,32,64
2801318,06/02/24,Liverpool,30,12,7,19,5,6,49,23,26,62
2801318,06/02/24,Tottenham,30,9,6,15,8,7,43,27,16,53
2801318,06/02/24,Manchester Blue,30,10,4,14,8,8,47,36,11,50
2801318,06/02/24,Bournemouth,30,7,6,13,9,8,42,35,7,48
2801318,06/02/24,West Ham,30,6,4,10,6,14,32,46,-14,36
2801318,06/02/24,Manchester Reds,30,8,6,14,7,9,42,36,6,49
2801318,06/02/24,Wolverhampton,30,7,2,9,10,11,30,34,-4,37
2801318,06/02/24,Watford,30,6,4,10,8,12,34,39,-5,38
2801318,06/02/24,London Guns,30,8,8,16,7,7,43,31,12,55
2801318,06/02/24,Everton,30,9,3,12,6,12,47,48,-1,42
2801318,06/02/24,Burnley,30,6,2,8,5,17,32,44,-12,29
2801318,06/02/24,Southampton,30,5,2,7,5,18,24,37,-13,26
2801318,06/02/24,Leicester,30,3,5,8,6,16,38,52,-14,30
2801318,06/02/24,Crystal Palace,30,2,3,5,5,20,27,56,-29,20
2801318,06/02/24,Newcastle,30,4,2,6,8,16,24,42,-18,26
2801344,06/02/24,Chelsea,30,9,10,19,5,6,61,26,35,62
2801344,06/02/24,Liverpool,30,8,7,15,7,8,44,34,10,52
2801344,06/02/24,Tottenham,30,10,9,19,5,6,60,28,32,62
2801344,06/02/24,Manchester Blue,30,8,8,16,3,11,56,42,14,51
2801344,06/02/24,Bournemouth,30,8,5,13,8,9,44,34,10,47
2801344,06/02/24,West Ham,30,2,4,6,5,19,21,43,-22,23
2801344,06/02/24,Manchester Reds,30,7,8,15,9,6,47,31,16,54
2801344,06/02/24,Wolverhampton,30,5,3,8,7,15,27,37,-10,31
2801344,06/02/24,Watford,30,6,3,9,5,16,32,45,-13,32
2801344,06/02/24,London Guns,30,8,6,14,9,7,51,34,17,51
2801344,06/02/24,Everton,30,5,6,11,10,9,37,35,2,43
2801344,06/02/24,Burnley,30,6,4,10,7,13,28,43,-15,37
2801344,06/02/24,Southampton,30,5,3,8,8,14,24,39,-15,32
2801344,06/02/24,Leicester,30,5,3,8,5,17,32,58,-26,29
2801344,06/02/24,Crystal Palace,30,5,3,8,5,17,30,40,-10,29
2801344,06/02/24,Newcastle,30,4,5,9,6,15,29,54,-25,33
2801372,07/02/24,Chelsea,30,9,7,16,7,7,53,27,26,55
2801372,07/02/24,Liverpool,30,8,3,11,6,13,42,39,3,39
2801372,07/02/24,Tottenham,30,7,6,13,8,9,44,35,9,47
2801372,07/02/24,Manchester Blue,30,9,11,20,3,7,54,33,21,63
2801372,07/02/24,Bournemouth,30,10,9,19,7,4,55,28,27,64
2801372,07/02/24,West Ham,30,4,1,5,8,17,29,60,-31,23
2801372,07/02/24,Manchester Reds,30,9,1,10,9,11,47,41,6,39
2801372,07/02/24,Wolverhampton,30,8,2,10,7,13,28,35,-7,37
2801372,07/02/24,Watford,30,8,3,11,10,9,38,36,2,43
2801372,07/02/24,London Guns,30,9,3,12,7,11,47,37,10,43
2801372,07/02/24,Everton,30,9,5,14,7,9,43,37,6,49
2801372,07/02/24,Burnley,30,3,5,8,10,12,26,39,-13,34
2801372,07/02/24,Southampton,30,6,1,7,7,16,23,49,-26,28
2801372,07/02/24,Leicester,30,9,5,14,7,9,49,37,12,49
2801372,07/02/24,Crystal Palace,30,5,1,6,6,18,29,49,-20,24
2801372,07/02/24,Newcastle,30,3,3,6,7,17,25,50,-25,25
2801397,07/02/24,Chelsea,30,9,4,13,8,9,51,46,5,47
2801397,07/02/24,Liverpool,30,10,5,15,6,9,45,35,10,51
2801397,07/02/24,Tottenham,30,9,5,14,5,11,60,46,14,47
2801397,07/02/24,Manchester Blue,30,5,9,14,8,8,51,35,16,50
2801397,07/02/24,Bournemouth,30,10,4,14,7,9,42,26,16,49
2801397,07/02/24,West Ham,30,4,4,8,5,17,27,48,-21,29
2801397,07/02/24,Manchester Reds,30,10,6,16,6,8,49,35,14,54
2801397,07/02/24,Wolverhampton,30,7,7,14,7,9,38,23,15,49
2801397,07/02/24,Watford,30,7,4,11,9,10,35,40,-5,42
2801397,07/02/24,London Guns,30,7,8,15,7,8,41,32,9,52
2801397,07/02/24,Everton,30,3,5,8,7,15,38,46,-8,31
2801397,07/02/24,Burnley,30,9,3,12,6,12,36,33,3,42
2801397,07/02/24,Southampton,30,2,4,6,9,15,35,50,-15,27
2801397,07/02/24,Leicester,30,5,4,9,9,12,38,49,-11,36
2801397,07/02/24,Crystal Palace,30,5,2,7,9,14,33,50,-17,30
2801397,07/02/24,Newcastle,30,4,3,7,6,17,28,53,-25,27
2801422,07/02/24,Chelsea,30,8,5,13,11,6,52,35,17,50
2801422,07/02/24,Liverpool,30,8,7,15,5,10,42,33,9,50
2801422,07/02/24,Tottenham,30,8,3,11,9,10,53,42,11,42
2801422,07/02/24,Manchester Blue,30,11,8,19,7,4,54,26,28,64
2801422,07/02/24,Bournemouth,30,11,10,21,3,6,49,24,25,66
2801422,07/02/24,West Ham,30,2,3,5,9,16,22,44,-22,24
2801422,07/02/24,Manchester Reds,30,6,6,12,7,11,50,42,8,43
2801422,07/02/24,Wolverhampton,30,7,9,16,6,8,30,21,9,54
2801422,07/02/24,Watford,30,3,2,5,3,22,20,58,-38,18
2801422,07/02/24,London Guns,30,9,7,16,8,6,50,25,25,56
2801422,07/02/24,Everton,30,7,3,10,5,15,43,51,-8,35
2801422,07/02/24,Burnley,30,5,5,10,7,13,30,35,-5,37
2801422,07/02/24,Southampton,30,7,4,11,4,15,34,46,-12,37
2801422,07/02/24,Leicester,30,6,4,10,6,14,37,43,-6,36
2801422,07/02/24,Crystal Palace,30,6,6,12,4,14,35,49,-14,40
2801422,07/02/24,Newcastle,30,3,2,5,4,21,19,46,-27,19
2801447,07/02/24,Chelsea,30,11,6,17,10,3,54,27,27,61
2801447,07/02/24,Liverpool,30,8,9,17,7,6,50,39,11,58
2801447,07/02/24,Tottenham,30,8,6,14,5,11,52,44,8,47
2801447,07/02/24,Manchester Blue,30,10,5,15,8,7,55,35,20,53
2801447,07/02/24,Bournemouth,30,8,8,16,8,6,47,27,20,56
2801447,07/02/24,West Ham,30,4,2,6,9,15,30,53,-23,27
2801447,07/02/24,Manchester Reds,30,9,8,17,5,8,50,27,23,56
2801447,07/02/24,Wolverhampton,30,8,2,10,7,13,26,33,-7,37
2801447,07/02/24,Watford,30,5,3,8,9,13,33,48,-15,33
2801447,07/02/24,London Guns,30,8,3,11,6,13,41,42,-1,39
2801447,07/02/24,Everton,30,4,7,11,7,12,36,40,-4,40
2801447,07/02/24,Burnley,30,5,2,7,7,16,26,40,-14,28
2801447,07/02/24,Southampton,30,6,4,10,7,13,35,34,1,37
2801447,07/02/24,Leicester,30,8,4,12,5,13,40,41,-1,41
2801447,07/02/24,Crystal Palace,30,1,2,3,8,19,28,57,-29,17
2801447,07/02/24,Newcastle,30,5,1,6,12,12,25,41,-16,30
2801473,07/02/24,Chelsea,30,6,7,13,7,10,40,32,8,46
2801473,07/02/24,Liverpool,30,12,10,22,4,4,63,26,37,70
2801473,07/02/24,Tottenham,30,6,7,13,11,6,45,33,12,50
2801473,07/02/24,Manchester Blue,30,12,7,19,7,4,59,25,34,64
2801473,07/02/24,Bournemouth,30,10,4,14,8,8,47,31,16,50
2801473,07/02/24,West Ham,30,5,2,7,5,18,26,46,-20,26
2801473,07/02/24,Manchester Reds,30,9,5,14,6,10,53,37,16,48
2801473,07/02/24,Wolverhampton,30,4,5,9,9,12,34,34,0,36
2801473,07/02/24,Watford,30,4,4,8,10,12,32,41,-9,34
2801473,07/02/24,London Guns,30,8,6,14,7,9,48,36,12,49
2801473,07/02/24,Everton,30,6,5,11,8,11,41,44,-3,41
2801473,07/02/24,Burnley,30,3,3,6,10,14,20,40,-20,28
2801473,07/02/24,Southampton,30,3,0,3,9,18,18,44,-26,18
2801473,07/02/24,Leicester,30,6,2,8,6,16,33,58,-25,30
2801473,07/02/24,Crystal Palace,30,6,2,8,9,13,28,44,-16,33
2801473,07/02/24,Newcastle,30,5,4,9,8,13,28,44,-16,35
2801497,07/02/24,Chelsea,30,7,6,13,8,9,46,32,14,47
2801497,07/02/24,Liverpool,30,9,8,17,7,6,52,28,24,58
2801497,07/02/24,Tottenham,30,10,7,17,5,8,63,35,28,56
2801497,07/02/24,Manchester Blue,30,6,7,13,5,12,47,39,8,44
2801497,07/02/24,Bournemouth,30,7,6,13,4,13,33,33,0,43
2801497,07/02/24,West Ham,30,3,1,4,9,17,19,41,-22,21
2801497,07/02/24,Manchester Reds,30,7,6,13,10,7,47,42,5,49
2801497,07/02/24,Wolverhampton,30,8,4,12,7,11,33,44,-11,43
2801497,07/02/24,Watford,30,6,5,11,5,14,30,46,-16,38
2801497,07/02/24,London Guns,30,15,8,23,3,4,55,22,33,72
2801497,07/02/24,Everton,30,7,6,13,7,10,43,39,4,46
2801497,07/02/24,Burnley,30,7,4,11,7,12,21,23,-2,40
2801497,07/02/24,Southampton,30,2,2,4,9,17,23,48,-25,21
2801497,07/02/24,Leicester,30,3,6,9,9,12,34,42,-8,36
2801497,07/02/24,Crystal Palace,30,5,3,8,5,17,30,48,-18,29
2801497,07/02/24,Newcastle,30,3,2,5,8,17,25,39,-14,23
2801523,07/02/24,Chelsea,30,7,5,12,8,10,37,33,4,44
2801523,07/02/24,Liverpool,30,10,8,18,3,9,42,30,12,57
2801523,07/02/24,Tottenham,30,7,7,14,4,12,48,46,2,46
2801523,07/02/24,Manchester Blue,30,10,7,17,7,6,52,35,17,58
2801523,07/02/24,Bournemouth,30,10,8,18,5,7,51,27,24,59
2801523,07/02/24,West Ham,30,6,3,9,5,16,34,53,-19,32
2801523,07/02/24,Manchester Reds,30,7,9,16,6,8,51,33,18,54
2801523,07/02/24,Wolverhampton,30,6,4,10,10,10,35,29,6,40
2801523,07/02/24,Watford,30,4,5,9,9,12,35,37,-2,36
2801523,07/02/24,London Guns,30,9,6,15,5,10,47,30,17,50
2801523,07/02/24,Everton,30,7,4,11,9,10,44,44,0,42
2801523,07/02/24,Burnley,30,5,3,8,5,17,29,34,-5,29
2801523,07/02/24,Southampton,30,3,1,4,13,13,28,47,-19,25
2801523,07/02/24,Leicester,30,7,2,9,9,12,46,57,-11,36
2801523,07/02/24,Crystal Palace,30,3,4,7,6,17,27,48,-21,27
2801523,07/02/24,Newcastle,30,5,3,8,6,16,28,51,-23,30
2801550,07/02/24,Chelsea,30,8,7,15,7,8,52,40,12,52
2801550,07/02/24,Liverpool,30,10,10,20,6,4,47,18,29,66
2801550,07/02/24,Tottenham,30,10,5,15,5,10,53,36,17,50
2801550,07/02/24,Manchester Blue,30,9,11,20,4,6,56,30,26,64
2801550,07/02/24,Bournemouth,30,9,6,15,3,12,46,34,12,48
2801550,07/02/24,West Ham,30,4,3,7,8,15,28,50,-22,29
2801550,07/02/24,Manchester Reds,30,8,8,16,4,10,56,33,23,52
2801550,07/02/24,Wolverhampton,30,6,3,9,11,10,31,32,-1,38
2801550,07/02/24,Watford,30,6,3,9,7,14,28,38,-10,34
2801550,07/02/24,London Guns,30,10,11,21,4,5,63,29,34,67
2801550,07/02/24,Everton,30,8,2,10,8,12,41,46,-5,38
2801550,07/02/24,Burnley,30,1,2,3,9,18,12,43,-31,18
2801550,07/02/24,Southampton,30,2,1,3,7,20,13,47,-34,16
2801550,07/02/24,Leicester,30,7,5,12,7,11,39,43,-4,43
2801550,07/02/24,Crystal Palace,30,4,0,4,9,17,21,53,-32,21
2801550,07/02/24,Newcastle,30,5,3,8,7,15,32,46,-14,31
2801576,07/02/24,Chelsea,30,9,4,13,11,6,47,31,16,50
2801576,07/02/24,Liverpool,30,9,12,21,4,5,56,23,33,67
2801576,07/02/24,Tottenham,30,6,2,8,12,10,42,38,4,36
2801576,07/02/24,Manchester Blue,30,10,8,18,5,7,53,27,26,59
2801576,07/02/24,Bournemouth,30,9,6,15,8,7,39,27,12,53
2801576,07/02/24,West Ham,30,5,3,8,9,13,31,41,-10,33
2801576,07/02/24,Manchester Reds,30,8,7,15,6,9,49,35,14,51
2801576,07/02/24,Wolverhampton,30,8,4,12,6,12,34,33,1,42
2801576,07/02/24,Watford,30,4,4,8,9,13,28,39,-11,33
2801576,07/02/24,London Guns,30,5,6,11,9,10,54,40,14,42
2801576,07/02/24,Everton,30,5,6,11,7,12,35,43,-8,40
2801576,07/02/24,Burnley,30,2,2,4,11,15,23,41,-18,23
2801576,07/02/24,Southampton,30,5,3,8,9,13,28,50,-22,33
2801576,07/02/24,Leicester,30,5,2,7,11,12,36,53,-17,32
2801576,07/02/24,Crystal Palace,30,5,4,9,9,12,33,42,-9,36
2801576,07/02/24,Newcastle,30,3,2,5,8,17,24,49,-25,23
2801600,07/02/24,Chelsea,30,7,7,14,6,10,40,29,11,48
2801600,07/02/24,Liverpool,30,10,6,16,7,7,45,26,19,55
2801600,07/02/24,Tottenham,30,5,6,11,9,10,39,35,4,42
2801600,07/02/24,Manchester Blue,30,9,6,15,7,8,56,35,21,52
2801600,07/02/24,Bournemouth,30,9,5,14,7,9,32,24,8,49
2801600,07/02/24,West Ham,30,4,1,5,9,16,21,37,-16,24
2801600,07/02/24,Manchester Reds,30,8,10,18,4,8,56,31,25,58
2801600,07/02/24,Wolverhampton,30,7,3,10,8,12,29,36,-7,38
2801600,07/02/24,Watford,30,7,1,8,8,14,31,41,-10,32
2801600,07/02/24,London Guns,30,7,8,15,7,8,49,36,13,52
2801600,07/02/24,Everton,30,8,7,15,8,7,39,35,4,53
2801600,07/02/24,Burnley,30,6,3,9,12,9,24,20,4,39
2801600,07/02/24,Southampton,30,3,0,3,10,17,17,45,-28,19
2801600,07/02/24,Leicester,30,7,8,15,7,8,44,40,4,52
2801600,07/02/24,Crystal Palace,30,2,3,5,6,19,25,54,-29,21
2801600,07/02/24,Newcastle,30,5,3,8,3,19,21,44,-23,27
2801628,07/02/24,Chelsea,30,10,6,16,10,4,52,26,26,58
2801628,07/02/24,Liverpool,30,10,7,17,7,6,43,27,16,58
2801628,07/02/24,Tottenham,30,9,5,14,10,6,46,30,16,52
2801628,07/02/24,Manchester Blue,30,7,5,12,12,6,53,34,19,48
2801628,07/02/24,Bournemouth,30,7,3,10,11,9,40,39,1,41
2801628,07/02/24,West Ham,30,5,2,7,7,16,25,46,-21,28
2801628,07/02/24,Manchester Reds,30,7,7,14,10,6,52,31,21,52
2801628,07/02/24,Wolverhampton,30,8,6,14,8,8,31,27,4,50
2801628,07/02/24,Watford,30,6,3,9,11,10,32,39,-7,38
2801628,07/02/24,London Guns,30,11,5,16,6,8,50,32,18,54
2801628,07/02/24,Everton,30,4,4,8,11,11,35,45,-10,35
2801628,07/02/24,Burnley,30,3,2,5,13,12,20,34,-14,28
2801628,07/02/24,Southampton,30,6,1,7,9,14,24,36,-12,30
2801628,07/02/24,Leicester,30,2,6,8,10,12,37,46,-9,34
2801628,07/02/24,Crystal Palace,30,3,0,3,6,21,26,50,-24,15
2801628,07/02/24,Newcastle,30,4,1,5,9,16,24,48,-24,24
2801651,07/02/24,Chelsea,30,9,7,16,9,5,55,34,21,57
2801651,07/02/24,Liverpool,30,8,9,17,6,7,51,26,25,57
2801651,07/02/24,Tottenham,30,12,5,17,8,5,51,31,20,59
2801651,07/02/24,Manchester Blue,30,10,10,20,5,5,70,29,41,65
2801651,07/02/24,Bournemouth,30,7,7,14,8,8,42,34,8,50
2801651,07/02/24,West Ham,30,5,3,8,8,14,33,50,-17,32
2801651,07/02/24,Manchester Reds,30,10,7,17,6,7,45,28,17,57
2801651,07/02/24,Wolverhampton,30,3,5,8,9,13,23,28,-5,33
2801651,07/02/24,Watford,30,3,4,7,7,16,27,49,-22,28
2801651,07/02/24,London Guns,30,10,7,17,3,10,55,38,17,54
2801651,07/02/24,Everton,30,7,2,9,9,12,34,41,-7,36
2801651,07/02/24,Burnley,30,4,5,9,4,17,35,50,-15,31
2801651,07/02/24,Southampton,30,1,3,4,7,19,17,47,-30,19
2801651,07/02/24,Leicester,30,3,5,8,4,18,44,64,-20,28
2801651,07/02/24,Crystal Palace,30,4,5,9,5,16,36,49,-13,32
2801651,07/02/24,Newcastle,30,4,3,7,8,15,31,51,-20,29
2801678,07/02/24,Chelsea,30,10,8,18,7,5,49,29,20,61
2801678,07/02/24,Liverpool,30,11,8,19,4,7,48,19,29,61
2801678,07/02/24,Tottenham,30,10,5,15,6,9,43,32,11,51
2801678,07/02/24,Manchester Blue,30,5,10,15,11,4,48,30,18,56
2801678,07/02/24,Bournemouth,30,8,2,10,8,12,33,42,-9,38
2801678,07/02/24,West Ham,30,5,1,6,5,19,28,46,-18,23
2801678,07/02/24,Manchester Reds,30,8,4,12,7,11,41,36,5,43
2801678,07/02/24,Wolverhampton,30,6,8,14,7,9,30,26,4,49
2801678,07/02/24,Watford,30,4,4,8,4,18,33,47,-14,28
2801678,07/02/24,London Guns,30,11,10,21,3,6,56,27,29,66
2801678,07/02/24,Everton,30,6,6,12,6,12,48,42,6,42
2801678,07/02/24,Burnley,30,5,3,8,8,14,31,39,-8,32
2801678,07/02/24,Southampton,30,3,2,5,9,16,21,42,-21,24
2801678,07/02/24,Leicester,30,3,3,6,9,15,35,54,-19,27
2801678,07/02/24,Crystal Palace,30,6,3,9,8,13,30,42,-12,35
2801678,07/02/24,Newcastle,30,5,1,6,10,14,28,49,-21,28
2801705,08/02/24,Chelsea,30,9,9,18,8,4,53,25,28,62
2801705,08/02/24,Liverpool,30,7,6,13,7,10,41,25,16,46
2801705,08/02/24,Tottenham,30,8,8,16,5,9,51,32,19,53
2801705,08/02/24,Manchester Blue,30,10,6,16,4,10,51,40,11,52
2801705,08/02/24,Bournemouth,30,8,6,14,7,9,30,26,4,49
2801705,08/02/24,West Ham,30,5,3,8,8,14,28,43,-15,32
2801705,08/02/24,Manchester Reds,30,6,5,11,11,8,46,36,10,44
2801705,08/02/24,Wolverhampton,30,9,3,12,5,13,35,37,-2,41
2801705,08/02/24,Watford,30,8,3,11,9,10,26,30,-4,42
2801705,08/02/24,London Guns,30,9,6,15,11,4,50,26,24,56
2801705,08/02/24,Everton,30,7,5,12,7,11,50,50,0,43
2801705,08/02/24,Burnley,30,5,2,7,11,12,27,30,-3,32
2801705,08/02/24,Southampton,30,2,1,3,10,17,16,46,-30,19
2801705,08/02/24,Leicester,30,5,3,8,8,14,40,55,-15,32
2801705,08/02/24,Crystal Palace,30,3,3,6,7,17,37,58,-21,25
2801705,08/02/24,Newcastle,30,6,2,8,6,16,28,50,-22,30
2801731,08/02/24,Chelsea,30,9,10,19,6,5,57,27,30,63
2801731,08/02/24,Liverpool,30,10,8,18,5,7,45,23,22,59
2801731,08/02/24,Tottenham,30,11,6,17,5,8,48,32,16,56
2801731,08/02/24,Manchester Blue,30,9,8,17,6,7,63,34,29,57
2801731,08/02/24,Bournemouth,30,7,4,11,9,10,39,26,13,42
2801731,08/02/24,West Ham,30,1,1,2,6,22,26,61,-35,12
2801731,08/02/24,Manchester Reds,30,9,6,15,5,10,44,34,10,50
2801731,08/02/24,Wolverhampton,30,5,8,13,8,9,28,23,5,47
2801731,08/02/24,Watford,30,9,2,11,9,10,36,39,-3,42
2801731,08/02/24,London Guns,30,7,8,15,6,9,49,37,12,51
2801731,08/02/24,Everton,30,4,1,5,11,14,34,48,-14,26
2801731,08/02/24,Burnley,30,2,5,7,10,13,27,50,-23,31
2801731,08/02/24,Southampton,30,4,2,6,10,14,31,48,-17,28
2801731,08/02/24,Leicester,30,8,5,13,6,11,50,42,8,45
2801731,08/02/24,Crystal Palace,30,2,6,8,9,13,32,44,-12,33
2801731,08/02/24,Newcastle,30,2,3,5,5,20,19,60,-41,20
2801754,08/02/24,Chelsea,30,10,9,19,7,4,51,22,29,64
2801754,08/02/24,Liverpool,30,9,8,17,5,8,49,30,19,56
2801754,08/02/24,Tottenham,30,6,4,10,5,15,37,51,-14,35
2801754,08/02/24,Manchester Blue,30,12,8,20,3,7,57,29,28,63
2801754,08/02/24,Bournemouth,30,11,7,18,6,6,42,27,15,60
2801754,08/02/24,West Ham,30,4,3,7,7,16,29,45,-16,28
2801754,08/02/24,Manchester Reds,30,5,6,11,7,12,41,36,5,40
2801754,08/02/24,Wolverhampton,30,10,2,12,9,9,41,34,7,45
2801754,08/02/24,Watford,30,7,5,12,11,7,42,31,11,47
2801754,08/02/24,London Guns,30,7,9,16,10,4,48,26,22,58
2801754,08/02/24,Everton,30,7,3,10,10,10,38,40,-2,40
2801754,08/02/24,Burnley,30,4,1,5,4,21,23,49,-26,19
2801754,08/02/24,Southampton,30,4,1,5,7,18,21,45,-24,22
2801754,08/02/24,Leicester,30,4,4,8,5,17,28,43,-15,29
2801754,08/02/24,Crystal Palace,30,4,4,8,4,18,34,62,-28,28
2801754,08/02/24,Newcastle,30,5,2,7,10,13,24,35,-11,31
2801781,08/02/24,Chelsea,30,8,3,11,9,10,40,35,5,42
2801781,08/02/24,Liverpool,30,7,8,15,5,10,52,36,16,50
2801781,08/02/24,Tottenham,30,6,4,10,10,10,49,42,7,40
2801781,08/02/24,Manchester Blue,30,8,6,14,11,5,58,35,23,53
2801781,08/02/24,Bournemouth,30,10,7,17,9,4,47,20,27,60
2801781,08/02/24,West Ham,30,4,5,9,10,11,43,36,7,37
2801781,08/02/24,Manchester Reds,30,10,9,19,4,7,54,34,20,61
2801781,08/02/24,Wolverhampton,30,6,6,12,10,8,34,29,5,46
2801781,08/02/24,Watford,30,7,3,10,8,12,38,42,-4,38
2801781,08/02/24,London Guns,30,5,8,13,7,10,48,39,9,46
2801781,08/02/24,Everton,30,6,3,9,7,14,37,45,-8,34
2801781,08/02/24,Burnley,30,3,5,8,10,12,29,37,-8,34
2801781,08/02/24,Southampton,30,7,1,8,7,15,29,49,-20,31
2801781,08/02/24,Leicester,30,8,7,15,6,9,47,36,11,51
2801781,08/02/24,Crystal Palace,30,2,1,3,5,22,20,71,-51,14
2801781,08/02/24,Newcastle,30,2,1,3,10,17,21,60,-39,19
2801803,08/02/24,Chelsea,30,9,7,16,8,6,48,31,17,56
2801803,08/02/24,Liverpool,30,9,3,12,9,9,44,30,14,45
2801803,08/02/24,Tottenham,30,8,3,11,10,9,43,35,8,43
2801803,08/02/24,Manchester Blue,30,13,10,23,5,2,73,27,46,74
2801803,08/02/24,Bournemouth,30,7,4,11,8,11,31,37,-6,41
2801803,08/02/24,West Ham,30,6,2,8,6,16,33,42,-9,30
2801803,08/02/24,Manchester Reds,30,8,4,12,7,11,40,40,0,43
2801803,08/02/24,Wolverhampton,30,7,2,9,7,14,20,32,-12,34
2801803,08/02/24,Watford,30,6,5,11,12,7,32,28,4,45
2801803,08/02/24,London Guns,30,10,6,16,4,10,45,36,9,52
2801803,08/02/24,Everton,30,7,5,12,3,15,37,52,-15,39
2801803,08/02/24,Burnley,30,8,0,8,8,14,30,46,-16,32
2801803,08/02/24,Southampton,30,5,2,7,7,16,35,48,-13,28
2801803,08/02/24,Leicester,30,5,4,9,4,17,41,58,-17,31
2801803,08/02/24,Crystal Palace,30,3,4,7,12,11,36,37,-1,33
2801803,08/02/24,Newcastle,30,6,2,8,10,12,33,42,-9,34
2801830,08/02/24,Chelsea,30,12,8,20,5,5,58,21,37,65
2801830,08/02/24,Liverpool,30,8,5,13,10,7,44,27,17,49
2801830,08/02/24,Tottenham,30,7,5,12,9,9,35,30,5,45
2801830,08/02/24,Manchester Blue,30,13,11,24,3,3,80,34,46,75
2801830,08/02/24,Bournemouth,30,8,7,15,9,6,45,33,12,54
2801830,08/02/24,West Ham,30,5,2,7,8,15,29,44,-15,29
2801830,08/02/24,Manchester Reds,30,7,8,15,6,9,43,29,14,51
2801830,08/02/24,Wolverhampton,30,6,5,11,7,12,27,41,-14,40
2801830,08/02/24,Watford,30,4,1,5,9,16,33,51,-18,24
2801830,08/02/24,London Guns,30,10,6,16,5,9,60,37,23,53
2801830,08/02/24,Everton,30,10,5,15,8,7,49,41,8,53
2801830,08/02/24,Burnley,30,4,1,5,6,19,18,45,-27,21
2801830,08/02/24,Southampton,30,3,1,4,8,18,23,58,-35,20
2801830,08/02/24,Leicester,30,6,6,12,7,11,47,45,2,43
2801830,08/02/24,Crystal Palace,30,3,3,6,8,16,34,52,-18,26
2801830,08/02/24,Newcastle,30,3,1,4,4,22,19,56,-37,16
2801857,08/02/24,Chelsea,30,9,9,18,7,5,47,26,21,61
2801857,08/02/24,Liverpool,30,9,6,15,7,8,49,24,25,52
2801857,08/02/24,Tottenham,30,7,8,15,8,7,48,28,20,53
2801857,08/02/24,Manchester Blue,30,6,8,14,6,10,57,41,16,48
2801857,08/02/24,Bournemouth,30,7,7,14,10,6,43,27,16,52
2801857,08/02/24,West Ham,30,3,5,8,8,14,27,43,-16,32
2801857,08/02/24,Manchester Reds,30,9,4,13,9,8,51,29,22,48
2801857,08/02/24,Wolverhampton,30,5,4,9,10,11,27,39,-12,37
2801857,08/02/24,Watford,30,4,5,9,8,13,31,44,-13,35
2801857,08/02/24,London Guns,30,10,10,20,5,5,55,26,29,65
2801857,08/02/24,Everton,30,7,7,14,4,12,34,37,-3,46
2801857,08/02/24,Burnley,30,5,4,9,4,17,36,52,-16,31
2801857,08/02/24,Southampton,30,1,2,3,8,19,13,45,-32,17
2801857,08/02/24,Leicester,30,7,2,9,10,11,36,46,-10,37
2801857,08/02/24,Crystal Palace,30,1,3,4,9,17,27,52,-25,21
2801857,08/02/24,Newcastle,30,1,5,6,7,17,32,54,-22,25
2801891,08/02/24,Chelsea,30,9,9,18,9,3,52,23,29,63
2801891,08/02/24,Liverpool,30,9,7,16,3,11,48,38,10,51
2801891,08/02/24,Tottenham,30,7,7,14,7,9,45,39,6,49
2801891,08/02/24,Manchester Blue,30,7,4,11,11,8,52,40,12,44
2801891,08/02/24,Bournemouth,30,7,3,10,9,11,39,41,-2,39
2801891,08/02/24,West Ham,30,6,1,7,8,15,26,45,-19,29
2801891,08/02/24,Manchester Reds,30,8,4,12,9,9,45,41,4,45
2801891,08/02/24,Wolverhampton,30,7,6,13,11,6,46,31,15,50
2801891,08/02/24,Watford,30,5,5,10,4,16,28,40,-12,34
2801891,08/02/24,London Guns,30,11,8,19,7,4,58,29,29,64
2801891,08/02/24,Everton,30,7,6,13,6,11,38,38,0,45
2801891,08/02/24,Burnley,30,5,3,8,10,12,26,33,-7,34
2801891,08/02/24,Southampton,30,3,4,7,4,19,27,52,-25,25
2801891,08/02/24,Leicester,30,7,1,8,8,14,33,41,-8,32
2801891,08/02/24,Crystal Palace,30,7,3,10,7,13,29,34,-5,37
2801891,08/02/24,Newcastle,30,5,0,5,5,20,25,52,-27,20
2801918,08/02/24,Chelsea,30,8,7,15,6,9,51,36,15,51
2801918,08/02/24,Liverpool,30,11,8,19,6,5,56,26,30,63
2801918,08/02/24,Tottenham,30,6,9,15,4,11,47,36,11,49
2801918,08/02/24,Manchester Blue,30,8,7,15,7,8,52,36,16,52
2801918,08/02/24,Bournemouth,30,8,7,15,8,7,47,25,22,53
2801918,08/02/24,West Ham,30,9,4,13,3,14,39,54,-15,42
2801918,08/02/24,Manchester Reds,30,12,5,17,7,6,59,27,32,58
2801918,08/02/24,Wolverhampton,30,4,3,7,6,17,21,42,-21,27
2801918,08/02/24,Watford,30,5,3,8,8,14,31,48,-17,32
2801918,08/02/24,London Guns,30,12,6,18,4,8,50,27,23,58
2801918,08/02/24,Everton,30,9,3,12,7,11,43,46,-3,43
2801918,08/02/24,Burnley,30,5,3,8,7,15,28,40,-12,31
2801918,08/02/24,Southampton,30,4,2,6,4,20,21,54,-33,22
2801918,08/02/24,Leicester,30,8,4,12,6,12,42,49,-7,42
2801918,08/02/24,Crystal Palace,30,3,2,5,5,20,29,57,-28,20
2801918,08/02/24,Newcastle,30,4,4,8,6,16,37,50,-13,30
2801945,08/02/24,Chelsea,30,9,9,18,3,9,61,37,24,57
2801945,08/02/24,Liverpool,30,9,7,16,5,9,49,27,22,53
2801945,08/02/24,Tottenham,30,9,7,16,7,7,47,33,14,55
2801945,08/02/24,Manchester Blue,30,12,7,19,5,6,66,26,40,62
2801945,08/02/24,Bournemouth,30,8,9,17,8,5,49,25,24,59
2801945,08/02/24,West Ham,30,3,3,6,7,17,24,56,-32,25
2801945,08/02/24,Manchester Reds,30,7,4,11,9,10,44,37,7,42
2801945,08/02/24,Wolverhampton,30,9,2,11,9,10,37,38,-1,42
2801945,08/02/24,Watford,30,8,2,10,10,10,39,38,1,40
2801945,08/02/24,London Guns,30,9,5,14,7,9,46,29,17,49
2801945,08/02/24,Everton,30,8,3,11,6,13,50,46,4,39
2801945,08/02/24,Burnley,30,3,6,9,6,15,24,41,-17,33
2801945,08/02/24,Southampton,30,2,4,6,7,17,25,49,-24,25
2801945,08/02/24,Leicester,30,3,4,7,6,17,26,60,-34,27
2801945,08/02/24,Crystal Palace,30,7,3,10,6,14,35,49,-14,36
2801945,08/02/24,Newcastle,30,4,2,6,5,19,28,59,-31,23
2801969,08/02/24,Chelsea,30,9,9,18,6,6,62,25,37,60
2801969,08/02/24,Liverpool,30,11,8,19,9,2,58,21,37,66
2801969,08/02/24,Tottenham,30,8,6,14,5,11,47,43,4,47
2801969,08/02/24,Manchester Blue,30,8,7,15,7,8,51,33,18,52
2801969,08/02/24,Bournemouth,30,8,9,17,10,3,45,20,25,61
2801969,08/02/24,West Ham,30,7,1,8,3,19,28,50,-22,27
2801969,08/02/24,Manchester Reds,30,7,4,11,9,10,40,40,0,42
2801969,08/02/24,Wolverhampton,30,5,4,9,7,14,28,35,-7,34
2801969,08/02/24,Watford,30,7,5,12,4,14,33,35,-2,40
2801969,08/02/24,London Guns,30,10,7,17,4,9,41,32,9,55
2801969,08/02/24,Everton,30,7,4,11,4,15,40,45,-5,37
2801969,08/02/24,Burnley,30,1,3,4,10,16,24,44,-20,22
2801969,08/02/24,Southampton,30,4,1,5,6,19,18,49,-31,21
2801969,08/02/24,Leicester,30,7,5,12,4,14,42,48,-6,40
2801969,08/02/24,Crystal Palace,30,3,5,8,6,16,37,65,-28,30
2801969,08/02/24,Newcastle,30,6,5,11,4,15,26,35,-9,37
2801995,08/02/24,Chelsea,30,11,8,19,6,5,50,25,25,63
2801995,08/02/24,Liverpool,30,7,5,12,10,8,44,27,17,46
2801995,08/02/24,Tottenham,30,10,8,18,8,4,49,23,26,62
2801995,08/02/24,Manchester Blue,30,10,5,15,8,7,51,32,19,53
2801995,08/02/24,Bournemouth,30,10,2,12,13,5,35,25,10,49
2801995,08/02/24,West Ham,30,6,4,10,11,9,36,34,2,41
2801995,08/02/24,Manchester Reds,30,8,5,13,8,9,42,38,4,47
2801995,08/02/24,Wolverhampton,30,9,3,12,10,8,36,26,10,46
2801995,08/02/24,Watford,30,7,3,10,12,8,35,33,2,42
2801995,08/02/24,London Guns,30,8,6,14,6,10,50,37,13,48
2801995,08/02/24,Everton,30,6,3,9,5,16,35,48,-13,32
2801995,08/02/24,Burnley,30,3,1,4,6,20,21,52,-31,18
2801995,08/02/24,Southampton,30,1,3,4,7,19,20,49,-29,19
2801995,08/02/24,Leicester,30,5,5,10,10,10,44,49,-5,40
2801995,08/02/24,Crystal Palace,30,5,4,9,3,18,31,50,-19,30
2801995,08/02/24,Newcastle,30,3,0,3,9,18,24,55,-31,18
2802021,08/02/24,Chelsea,30,9,9,18,6,6,51,27,24,60
2802021,08/02/24,Liverpool,30,9,7,16,3,11,46,32,14,51
2802021,08/02/24,Tottenham,30,6,4,10,7,13,32,33,-1,37
2802021,08/02/24,Manchester Blue,30,12,10,22,3,5,71,27,44,69
2802021,08/02/24,Bournemouth,30,9,5,14,9,7,43,30,13,51
2802021,08/02/24,West Ham,30,2,6,8,7,15,30,41,-11,31
2802021,08/02/24,Manchester Reds,30,9,10,19,2,9,51,30,21,59
2802021,08/02/24,Wolverhampton,30,7,5,12,8,10,34,23,11,44
2802021,08/02/24,Watford,30,5,6,11,6,13,28,42,-14,39
2802021,08/02/24,London Guns,30,9,7,16,8,6,47,28,19,56
2802021,08/02/24,Everton,30,4,4,8,5,17,39,54,-15,29
2802021,08/02/24,Burnley,30,6,4,10,6,14,23,32,-9,36
2802021,08/02/24,Southampton,30,6,2,8,8,14,26,42,-16,32
2802021,08/02/24,Leicester,30,4,4,8,9,13,29,48,-19,33
2802021,08/02/24,Crystal Palace,30,2,3,5,9,16,26,51,-25,24
2802021,08/02/24,Newcastle,30,3,2,5,4,21,19,55,-36,19
2802051,09/02/24,Chelsea,30,9,9,18,5,7,47,30,17,59
2802051,09/02/24,Liverpool,30,11,5,16,6,8,50,30,20,54
2802051,09/02/24,Tottenham,30,7,7,14,10,6,50,30,20,52
2802051,09/02/24,Manchester Blue,30,9,5,14,9,7,54,30,24,51
2802051,09/02/24,Bournemouth,30,7,7,14,10,6,44,29,15,52
2802051,09/02/24,West Ham,30,5,1,6,9,15,33,51,-18,27
2802051,09/02/24,Manchester Reds,30,7,7,14,7,9,51,38,13,49
2802051,09/02/24,Wolverhampton,30,4,7,11,3,16,33,46,-13,36
2802051,09/02/24,Watford,30,6,6,12,8,10,40,37,3,44
2802051,09/02/24,London Guns,30,9,7,16,7,7,57,33,24,55
2802051,09/02/24,Everton,30,6,8,14,4,12,43,39,4,46
2802051,09/02/24,Burnley,30,2,5,7,9,14,23,38,-15,30
2802051,09/02/24,Southampton,30,1,3,4,10,16,21,44,-23,22
2802051,09/02/24,Leicester,30,6,2,8,6,16,31,57,-26,30
2802051,09/02/24,Crystal Palace,30,4,3,7,8,15,25,48,-23,29
2802051,09/02/24,Newcastle,30,4,1,5,9,16,21,43,-22,24
2802077,09/02/24,Chelsea,30,9,6,15,11,4,53,32,21,56
2802077,09/02/24,Liverpool,30,7,5,12,8,10,40,32,8,44
2802077,09/02/24,Tottenham,30,9,3,12,5,13,39,35,4,41
2802077,09/02/24,Manchester Blue,30,8,10,18,5,7,48,28,20,59
2802077,09/02/24,Bournemouth,30,8,9,17,6,7,52,37,15,57
2802077,09/02/24,West Ham,30,4,1,5,6,19,30,62,-32,21
2802077,09/02/24,Manchester Reds,30,7,3,10,12,8,44,35,9,42
2802077,09/02/24,Wolverhampton,30,6,3,9,11,10,33,33,0,38
2802077,09/02/24,Watford,30,7,1,8,4,18,31,56,-25,28
2802077,09/02/24,London Guns,30,9,7,16,8,6,47,33,14,56
2802077,09/02/24,Everton,30,7,2,9,10,11,38,44,-6,37
2802077,09/02/24,Burnley,30,4,0,4,9,17,16,38,-22,21
2802077,09/02/24,Southampton,30,3,5,8,13,9,34,41,-7,37
2802077,09/02/24,Leicester,30,9,5,14,6,10,46,35,11,48
2802077,09/02/24,Crystal Palace,30,4,4,8,10,12,32,40,-8,34
2802077,09/02/24,Newcastle,30,4,5,9,8,13,34,36,-2,35
2802103,09/02/24,Chelsea,30,11,6,17,6,7,46,24,22,57
2802103,09/02/24,Liverpool,30,9,10,19,8,3,50,24,26,65
2802103,09/02/24,Tottenham,30,7,6,13,8,9,37,29,8,47
2802103,09/02/24,Manchester Blue,30,9,4,13,10,7,53,36,17,49
2802103,09/02/24,Bournemouth,30,11,8,19,4,7,48,25,23,61
2802103,09/02/24,West Ham,30,3,2,5,11,14,29,44,-15,26
2802103,09/02/24,Manchester Reds,30,7,4,11,7,12,38,38,0,40
2802103,09/02/24,Wolverhampton,30,3,4,7,9,14,23,33,-10,30
2802103,09/02/24,Watford,30,7,3,10,7,13,27,41,-14,37
2802103,09/02/24,London Guns,30,8,8,16,9,5,52,31,21,57
2802103,09/02/24,Everton,30,6,5,11,11,8,44,41,3,44
2802103,09/02/24,Burnley,30,3,3,6,9,15,22,40,-18,27
2802103,09/02/24,Southampton,30,3,2,5,9,16,18,37,-19,24
2802103,09/02/24,Leicester,30,5,5,10,6,14,38,51,-13,36
2802103,09/02/24,Crystal Palace,30,7,3,10,6,14,31,38,-7,36
2802103,09/02/24,Newcastle,30,3,2,5,6,19,25,49,-24,21
2802128,09/02/24,Chelsea,30,8,7,15,6,9,43,31,12,51
2802128,09/02/24,Liverpool,30,12,5,17,4,9,46,32,14,55
2802128,09/02/24,Tottenham,30,10,7,17,6,7,56,31,25,57
2802128,09/02/24,Manchester Blue,30,13,4,17,7,6,62,29,33,58
2802128,09/02/24,Bournemouth,30,10,8,18,4,8,38,22,16,58
2802128,09/02/24,West Ham,30,3,1,4,11,15,26,52,-26,23
2802128,09/02/24,Manchester Reds,30,10,4,14,10,6,47,37,10,52
2802128,09/02/24,Wolverhampton,30,7,2,9,9,12,31,34,-3,36
2802128,09/02/24,Watford,30,9,6,15,5,10,47,45,2,50
2802128,09/02/24,London Guns,30,7,6,13,5,12,50,38,12,44
2802128,09/02/24,Everton,30,9,4,13,4,13,48,46,2,43
2802128,09/02/24,Burnley,30,6,2,8,4,18,18,40,-22,28
2802128,09/02/24,Southampton,30,5,4,9,7,14,24,40,-16,34
2802128,09/02/24,Leicester,30,4,2,6,7,17,24,44,-20,25
2802128,09/02/24,Crystal Palace,30,5,3,8,6,16,34,50,-16,30
2802128,09/02/24,Newcastle,30,4,2,6,7,17,26,49,-23,25
2802153,09/02/24,Chelsea,30,9,6,15,8,7,47,35,12,53
2802153,09/02/24,Liverpool,30,10,9,19,6,5,50,21,29,63
2802153,09/02/24,Tottenham,30,11,6,17,5,8,57,32,25,56
2802153,09/02/24,Manchester Blue,30,8,7,15,7,8,55,28,27,52
2802153,09/02/24,Bournemouth,30,5,6,11,11,8,32,27,5,44
2802153,09/02/24,West Ham,30,7,2,9,8,13,30,36,-6,35
2802153,09/02/24,Manchester Reds,30,9,6,15,5,10,45,26,19,50
2802153,09/02/24,Wolverhampton,30,7,3,10,9,11,27,31,-4,39
2802153,09/02/24,Watford,30,4,3,7,9,14,28,36,-8,30
2802153,09/02/24,London Guns,30,8,5,13,8,9,42,30,12,47
2802153,09/02/24,Everton,30,7,3,10,5,15,38,47,-9,35
2802153,09/02/24,Burnley,30,3,3,6,8,16,20,42,-22,26
2802153,09/02/24,Southampton,30,8,3,11,3,16,29,54,-25,36
2802153,09/02/24,Leicester,30,7,1,8,8,14,34,51,-17,32
2802153,09/02/24,Crystal Palace,30,6,3,9,9,12,31,42,-11,36
2802153,09/02/24,Newcastle,30,6,1,7,7,16,16,43,-27,28
2802176,09/02/24,Chelsea,30,9,4,13,13,4,46,22,24,52
2802176,09/02/24,Liverpool,30,10,7,17,9,4,46,25,21,60
2802176,09/02/24,Tottenham,30,10,7,17,6,7,48,27,21,57
2802176,09/02/24,Manchester Blue,30,9,7,16,11,3,67,36,31,59
2802176,09/02/24,Bournemouth,30,9,4,13,10,7,47,39,8,49
2802176,09/02/24,West Ham,30,5,3,8,7,15,33,47,-14,31
2802176,09/02/24,Manchester Reds,30,5,4,9,11,10,38,40,-2,38
2802176,09/02/24,Wolverhampton,30,5,3,8,9,13,32,38,-6,33
2802176,09/02/24,Watford,30,4,2,6,12,12,32,45,-13,30
2802176,09/02/24,London Guns,30,7,6,13,12,5,44,30,14,51
2802176,09/02/24,Everton,30,4,4,8,14,8,36,39,-3,38
2802176,09/02/24,Burnley,30,3,2,5,12,13,25,40,-15,27
2802176,09/02/24,Southampton,30,4,3,7,7,16,26,46,-20,28
2802176,09/02/24,Leicester,30,6,1,7,12,11,37,39,-2,33
2802176,09/02/24,Crystal Palace,30,6,5,11,5,14,34,53,-19,38
2802176,09/02/24,Newcastle,30,1,0,1,12,17,24,49,-25,15
2802202,09/02/24,Chelsea,30,9,7,16,7,7,45,28,17,55
2802202,09/02/24,Liverpool,30,8,5,13,6,11,45,30,15,45
2802202,09/02/24,Tottenham,30,9,3,12,8,10,46,37,9,44
2802202,09/02/24,Manchester Blue,30,9,4,13,8,9,52,38,14,47
2802202,09/02/24,Bournemouth,30,8,8,16,7,7,47,28,19,55
2802202,09/02/24,West Ham,30,2,2,4,9,17,21,46,-25,21
2802202,09/02/24,Manchester Reds,30,10,7,17,5,8,47,29,18,56
2802202,09/02/24,Wolverhampton,30,7,6,13,5,12,28,30,-2,44
2802202,09/02/24,Watford,30,8,5,13,6,11,37,37,0,45
2802202,09/02/24,London Guns,30,8,9,17,8,5,49,31,18,59
2802202,09/02/24,Everton,30,10,5,15,6,9,45,34,11,51
2802202,09/02/24,Burnley,30,5,0,5,5,20,20,52,-32,20
2802202,09/02/24,Southampton,30,6,2,8,6,16,24,41,-17,30
2802202,09/02/24,Leicester,30,5,7,12,4,14,37,44,-7,40
2802202,09/02/24,Crystal Palace,30,4,4,8,7,15,25,43,-18,31
2802202,09/02/24,Newcastle,30,6,0,6,7,17,25,45,-20,25
2802230,09/02/24,Chelsea,30,11,6,17,6,7,50,28,22,57
2802230,09/02/24,Liverpool,30,12,7,19,7,4,55,30,25,64
2802230,09/02/24,Tottenham,30,9,2,11,6,13,44,51,-7,39
2802230,09/02/24,Manchester Blue,30,11,7,18,5,7,61,36,25,59
2802230,09/02/24,Bournemouth,30,7,6,13,10,7,40,31,9,49
2802230,09/02/24,West Ham,30,4,2,6,9,15,32,61,-29,27
2802230,09/02/24,Manchester Reds,30,8,6,14,11,5,44,29,15,53
2802230,09/02/24,Wolverhampton,30,6,2,8,7,15,26,38,-12,31
2802230,09/02/24,Watford,30,7,5,12,8,10,35,35,0,44
2802230,09/02/24,London Guns,30,7,5,12,8,10,61,41,20,44
2802230,09/02/24,Everton,30,5,7,12,7,11,44,48,-4,43
2802230,09/02/24,Burnley,30,10,0,10,11,9,31,32,-1,41
2802230,09/02/24,Southampton,30,5,0,5,8,17,17,39,-22,23
2802230,09/02/24,Leicester,30,8,3,11,7,12,39,40,-1,40
2802230,09/02/24,Crystal Palace,30,4,1,5,8,17,29,45,-16,23
2802230,09/02/24,Newcastle,30,2,2,4,8,18,33,57,-24,20
2802254,09/02/24,Chelsea,30,11,6,17,5,8,50,31,19,56
2802254,09/02/24,Liverpool,30,11,6,17,8,5,53,28,25,59
2802254,09/02/24,Tottenham,30,10,8,18,6,6,54,29,25,60
2802254,09/02/24,Manchester Blue,30,8,10,18,10,2,57,29,28,64
2802254,09/02/24,Bournemouth,30,4,6,10,11,9,31,28,3,41
2802254,09/02/24,West Ham,30,6,2,8,9,13,31,45,-14,33
2802254,09/02/24,Manchester Reds,30,10,8,18,4,8,54,31,23,58
2802254,09/02/24,Wolverhampton,30,4,3,7,10,13,24,35,-11,31
2802254,09/02/24,Watford,30,5,1,6,9,15,27,42,-15,27
2802254,09/02/24,London Guns,30,6,8,14,11,5,46,25,21,53
2802254,09/02/24,Everton,30,3,5,8,8,14,34,45,-11,32
2802254,09/02/24,Burnley,30,4,4,8,8,14,29,50,-21,32
2802254,09/02/24,Southampton,30,5,3,8,8,14,32,49,-17,32
2802254,09/02/24,Leicester,30,3,5,8,6,16,41,54,-13,30
2802254,09/02/24,Crystal Palace,30,6,1,7,4,19,31,51,-20,25
2802254,09/02/24,Newcastle,30,4,1,5,9,16,29,51,-22,24
2802282,09/02/24,Chelsea,30,9,9,18,8,4,54,25,29,62
2802282,09/02/24,Liverpool,30,11,8,19,4,7,48,22,26,61
2802282,09/02/24,Tottenham,30,8,5,13,6,11,54,43,11,45
2802282,09/02/24,Manchester Blue,30,9,8,17,5,8,62,39,23,56
2802282,09/02/24,Bournemouth,30,10,6,16,8,6,46,27,19,56
2802282,09/02/24,West Ham,30,2,4,6,11,13,25,45,-20,29
2802282,09/02/24,Manchester Reds,30,7,3,10,12,8,47,34,13,42
2802282,09/02/24,Wolverhampton,30,8,5,13,8,9,31,31,0,47
2802282,09/02/24,Watford,30,5,3,8,8,14,26,44,-18,32
2802282,09/02/24,London Guns,30,9,5,14,11,5,54,30,24,53
2802282,09/02/24,Everton,30,10,5,15,4,11,51,43,8,49
2802282,09/02/24,Burnley,30,5,2,7,6,17,25,39,-14,27
2802282,09/02/24,Southampton,30,3,2,5,4,21,17,52,-35,19
2802282,09/02/24,Leicester,30,9,5,14,5,11,47,53,-6,47
2802282,09/02/24,Crystal Palace,30,1,2,3,8,19,32,59,-27,17
2802282,09/02/24,Newcastle,30,5,1,6,4,20,29,62,-33,22
2802308,09/02/24,Chelsea,30,9,5,14,10,6,49,32,17,52
2802308,09/02/24,Liverpool,30,8,6,14,7,9,46,26,20,49
2802308,09/02/24,Tottenham,30,10,8,18,4,8,60,37,23,58
2802308,09/02/24,Manchester Blue,30,7,5,12,8,10,51,38,13,44
2802308,09/02/24,Bournemouth,30,9,6,15,9,6,47,31,16,54
2802308,09/02/24,West Ham,30,3,5,8,7,15,30,45,-15,31
2802308,09/02/24,Manchester Reds,30,12,8,20,3,7,50,31,19,63
2802308,09/02/24,Wolverhampton,30,6,7,13,7,10,36,32,4,46
2802308,09/02/24,Watford,30,2,2,4,7,19,20,44,-24,19
2802308,09/02/24,London Guns,30,10,6,16,7,7,57,35,22,55
2802308,09/02/24,Everton,30,6,3,9,10,11,36,44,-8,37
2802308,09/02/24,Burnley,30,5,2,7,7,16,17,39,-22,28
2802308,09/02/24,Southampton,30,1,1,2,9,19,15,45,-30,15
2802308,09/02/24,Leicester,30,8,4,12,6,12,45,48,-3,42
2802308,09/02/24,Crystal Palace,30,8,5,13,4,13,40,46,-6,43
2802308,09/02/24,Newcastle,30,3,3,6,9,15,26,52,-26,27
2802332,09/02/24,Chelsea,30,10,6,16,8,6,42,28,14,56
2802332,09/02/24,Liverpool,30,7,7,14,6,10,52,34,18,48
2802332,09/02/24,Tottenham,30,11,5,16,5,9,55,42,13,53
2802332,09/02/24,Manchester Blue,30,10,7,17,5,8,56,35,21,56
2802332,09/02/24,Bournemouth,30,6,7,13,10,7,42,34,8,49
2802332,09/02/24,West Ham,30,4,2,6,6,18,26,57,-31,24
2802332,09/02/24,Manchester Reds,30,9,5,14,6,10,43,40,3,48
2802332,09/02/24,Wolverhampton,30,11,3,14,3,13,40,31,9,45
2802332,09/02/24,Watford,30,5,1,6,12,12,39,47,-8,30
2802332,09/02/24,London Guns,30,9,7,16,6,8,45,28,17,54
2802332,09/02/24,Everton,30,6,5,11,5,14,38,46,-8,38
2802332,09/02/24,Burnley,30,6,4,10,9,11,34,37,-3,39
2802332,09/02/24,Southampton,30,2,3,5,9,16,26,45,-19,24
2802332,09/02/24,Leicester,30,8,3,11,4,15,39,46,-7,37
2802332,09/02/24,Crystal Palace,30,4,3,7,9,14,35,49,-14,30
2802332,09/02/24,Newcastle,30,5,2,7,11,12,26,39,-13,32
2802357,09/02/24,Chelsea,30,5,8,13,9,8,40,36,4,48
2802357,09/02/24,Liverpool,30,6,8,14,10,6,50,33,17,52
2802357,09/02/24,Tottenham,30,11,8,19,3,8,53,33,20,60
2802357,09/02/24,Manchester Blue,30,8,8,16,8,6,55,29,26,56
2802357,09/02/24,Bournemouth,30,6,6,12,7,11,37,34,3,43
2802357,09/02/24,West Ham,30,3,4,7,10,13,30,41,-11,31
2802357,09/02/24,Manchester Reds,30,9,8,17,3,10,51,36,15,54
2802357,09/02/24,Wolverhampton,30,3,5,8,9,13,25,29,-4,33
2802357,09/02/24,Watford,30,7,3,10,7,13,28,30,-2,37
2802357,09/02/24,London Guns,30,12,6,18,4,8,54,28,26,58
2802357,09/02/24,Everton,30,6,5,11,9,10,34,40,-6,42
2802357,09/02/24,Burnley,30,4,2,6,6,18,19,50,-31,24
2802357,09/02/24,Southampton,30,2,2,4,11,15,20,38,-18,23
2802357,09/02/24,Leicester,30,5,5,10,8,12,40,44,-4,38
2802357,09/02/24,Crystal Palace,30,8,4,12,8,10,36,38,-2,44
2802357,09/02/24,Newcastle,30,4,1,5,4,21,18,51,-33,19
2802386,10/02/24,Chelsea,30,11,8,19,4,7,49,22,27,61
2802386,10/02/24,Liverpool,30,11,8,19,8,3,52,25,27,65
2802386,10/02/24,Tottenham,30,8,5,13,7,10,35,30,5,46
2802386,10/02/24,Manchester Blue,30,13,7,20,5,5,75,31,44,65
2802386,10/02/24,Bournemouth,30,4,5,9,11,10,32,30,2,38
2802386,10/02/24,West Ham,30,8,4,12,9,9,34,47,-13,45
2802386,10/02/24,Manchester Reds,30,9,7,16,3,11,46,39,7,51
2802386,10/02/24,Wolverhampton,30,9,6,15,4,11,36,29,7,49
2802386,10/02/24,Watford,30,7,5,12,6,12,34,44,-10,42
2802386,10/02/24,London Guns,30,8,6,14,7,9,45,29,16,49
2802386,10/02/24,Everton,30,6,1,7,11,12,26,39,-13,32
2802386,10/02/24,Burnley,30,1,4,5,6,19,21,46,-25,21
2802386,10/02/24,Southampton,30,2,1,3,8,19,19,43,-24,17
2802386,10/02/24,Leicester,30,4,2,6,12,12,36,42,-6,30
2802386,10/02/24,Crystal Palace,30,3,2,5,11,14,21,44,-23,26
2802386,10/02/24,Newcastle,30,3,0,3,12,15,23,44,-21,21
2802409,10/02/24,Chelsea,30,9,6,15,9,6,45,31,14,54
2802409,10/02/24,Liverpool,30,8,5,13,11,6,45,31,14,50
2802409,10/02/24,Tottenham,30,7,2,9,12,9,40,36,4,39
2802409,10/02/24,Manchester Blue,30,8,4,12,7,11,51,45,6,43
2802409,10/02/24,Bournemouth,30,10,7,17,11,2,52,26,26,62
2802409,10/02/24,West Ham,30,5,6,11,8,11,32,35,-3,41
2802409,10/02/24,Manchester Reds,30,7,4,11,10,9,42,37,5,43
2802409,10/02/24,Wolverhampton,30,6,4,10,8,12,37,36,1,38
2802409,10/02/24,Watford,30,8,4,12,11,7,43,34,9,47
2802409,10/02/24,London Guns,30,9,5,14,10,6,44,26,18,52
2802409,10/02/24,Everton,30,5,4,9,9,12,40,44,-4,36
2802409,10/02/24,Burnley,30,5,0,5,9,16,25,40,-15,24
2802409,10/02/24,Southampton,30,6,2,8,5,17,24,47,-23,29
2802409,10/02/24,Leicester,30,3,3,6,8,16,30,49,-19,26
2802409,10/02/24,Crystal Palace,30,4,4,8,9,13,25,43,-18,33
2802409,10/02/24,Newcastle,30,4,3,7,9,14,30,45,-15,30
2802435,10/02/24,Chelsea,30,6,6,12,13,5,41,25,16,49
2802435,10/02/24,Liverpool,30,12,9,21,5,4,55,26,29,68
2802435,10/02/24,Tottenham,30,10,4,14,10,6,52,32,20,52
2802435,10/02/24,Manchester Blue,30,11,7,18,5,7,52,33,19,59
2802435,10/02/24,Bournemouth,30,5,5,10,9,11,38,35,3,39
2802435,10/02/24,West Ham,30,7,0,7,6,17,43,61,-18,27
2802435,10/02/24,Manchester Reds,30,7,3,10,10,10,44,50,-6,40
2802435,10/02/24,Wolverhampton,30,5,6,11,8,11,32,30,2,41
2802435,10/02/24,Watford,30,8,3,11,9,10,34,36,-2,42
2802435,10/02/24,London Guns,30,7,7,14,8,8,49,37,12,50
2802435,10/02/24,Everton,30,6,7,13,8,9,45,34,11,47
2802435,10/02/24,Burnley,30,6,2,8,9,13,20,32,-12,33
2802435,10/02/24,Southampton,30,5,4,9,9,12,27,38,-11,36
2802435,10/02/24,Leicester,30,4,5,9,5,16,48,58,-10,32
2802435,10/02/24,Crystal Palace,30,4,5,9,2,19,32,49,-17,29
2802435,10/02/24,Newcastle,30,1,1,2,8,20,21,57,-36,14
2802460,10/02/24,Chelsea,30,9,5,14,8,8,51,37,14,50
2802460,10/02/24,Liverpool,30,10,8,18,6,6,51,30,21,60
2802460,10/02/24,Tottenham,30,8,5,13,5,12,33,38,-5,44
2802460,10/02/24,Manchester Blue,30,11,5,16,5,9,57,35,22,53
2802460,10/02/24,Bournemouth,30,8,5,13,3,14,50,49,1,42
2802460,10/02/24,West Ham,30,6,4,10,5,15,32,51,-19,35
2802460,10/02/24,Manchester Reds,30,8,8,16,7,7,51,26,25,55
2802460,10/02/24,Wolverhampton,30,7,2,9,11,10,32,36,-4,38
2802460,10/02/24,Watford,30,5,3,8,9,13,24,30,-6,33
2802460,10/02/24,London Guns,30,9,9,18,5,7,73,31,42,59
2802460,10/02/24,Everton,30,8,5,13,7,10,38,38,0,46
2802460,10/02/24,Burnley,30,5,5,10,7,13,27,36,-9,37
2802460,10/02/24,Southampton,30,4,2,6,8,16,26,49,-23,26
2802460,10/02/24,Leicester,30,4,3,7,10,13,40,47,-7,31
2802460,10/02/24,Crystal Palace,30,6,4,10,1,19,26,52,-26,31
2802460,10/02/24,Newcastle,30,2,5,7,7,16,28,54,-26,28
2802487,10/02/24,Chelsea,30,13,4,17,6,7,49,31,18,57
2802487,10/02/24,Liverpool,30,9,10,19,6,5,48,32,16,63
2802487,10/02/24,Tottenham,30,7,5,12,9,9,44,35,9,45
2802487,10/02/24,Manchester Blue,30,10,4,14,7,9,45,30,15,49
2802487,10/02/24,Bournemouth,30,5,3,8,10,12,34,42,-8,34
2802487,10/02/24,West Ham,30,3,2,5,6,19,27,48,-21,21
2802487,10/02/24,Manchester Reds,30,7,5,12,10,8,44,35,9,46
2802487,10/02/24,Wolverhampton,30,5,4,9,12,9,25,24,1,39
2802487,10/02/24,Watford,30,6,5,11,8,11,33,35,-2,41
2802487,10/02/24,London Guns,30,8,11,19,7,4,61,30,31,64
2802487,10/02/24,Everton,30,7,4,11,9,10,45,42,3,42
2802487,10/02/24,Burnley,30,5,3,8,4,18,24,35,-11,28
2802487,10/02/24,Southampton,30,8,0,8,6,16,26,42,-16,30
2802487,10/02/24,Leicester,30,9,3,12,6,12,36,43,-7,42
2802487,10/02/24,Crystal Palace,30,4,2,6,13,11,29,37,-8,31
2802487,10/02/24,Newcastle,30,3,2,5,9,16,20,49,-29,24
2802511,10/02/24,Chelsea,30,11,8,19,6,5,56,27,29,63
2802511,10/02/24,Liverpool,30,11,5,16,8,6,63,32,31,56
2802511,10/02/24,Tottenham,30,5,3,8,8,14,33,45,-12,32
2802511,10/02/24,Manchester Blue,30,11,7,18,5,7,50,30,20,59
2802511,10/02/24,Bournemouth,30,6,6,12,9,9,38,29,9,45
2802511,10/02/24,West Ham,30,4,1,5,5,20,22,46,-24,20
2802511,10/02/24,Manchester Reds,30,7,5,12,8,10,39,40,-1,44
2802511,10/02/24,Wolverhampton,30,6,7,13,9,8,39,24,15,48
2802511,10/02/24,Watford,30,9,6,15,5,10,45,41,4,50
2802511,10/02/24,London Guns,30,9,8,17,9,4,57,23,34,60
2802511,10/02/24,Everton,30,5,6,11,4,15,31,43,-12,37
2802511,10/02/24,Burnley,30,4,1,5,8,17,26,42,-16,23
2802511,10/02/24,Southampton,30,7,1,8,4,18,30,60,-30,28
2802511,10/02/24,Leicester,30,8,3,11,9,10,43,49,-6,42
2802511,10/02/24,Crystal Palace,30,8,1,9,7,14,29,47,-18,34
2802511,10/02/24,Newcastle,30,3,2,5,8,17,23,46,-23,23
2802541,10/02/24,Chelsea,30,11,4,15,11,4,47,22,25,56
2802541,10/02/24,Liverpool,30,13,8,21,4,5,62,28,34,67
2802541,10/02/24,Tottenham,30,8,3,11,8,11,49,43,6,41
2802541,10/02/24,Manchester Blue,30,10,8,18,7,5,59,26,33,61
2802541,10/02/24,Bournemouth,30,8,8,16,8,6,46,26,20,56
2802541,10/02/24,West Ham,30,4,3,7,8,15,25,43,-18,29
2802541,10/02/24,Manchester Reds,30,9,5,14,9,7,49,29,20,51
2802541,10/02/24,Wolverhampton,30,7,2,9,9,12,22,31,-9,36
2802541,10/02/24,Watford,30,6,1,7,8,15,34,43,-9,29
2802541,10/02/24,London Guns,30,8,9,17,3,10,39,32,7,54
2802541,10/02/24,Everton,30,4,4,8,6,16,28,45,-17,30
2802541,10/02/24,Burnley,30,6,4,10,7,13,30,37,-7,37
2802541,10/02/24,Southampton,30,3,3,6,11,13,27,40,-13,29
2802541,10/02/24,Leicester,30,5,5,10,7,13,31,48,-17,37
2802541,10/02/24,Crystal Palace,30,4,2,6,5,19,29,55,-26,23
2802541,10/02/24,Newcastle,30,2,5,7,5,18,28,57,-29,26
2802564,10/02/24,Chelsea,30,11,7,18,9,3,52,23,29,63
2802564,10/02/24,Liverpool,30,10,6,16,10,4,50,28,22,58
2802564,10/02/24,Tottenham,30,8,8,16,9,5,42,28,14,57
2802564,10/02/24,Manchester Blue,30,10,7,17,4,9,51,34,17,55
2802564,10/02/24,Bournemouth,30,8,8,16,7,7,40,27,13,55
2802564,10/02/24,West Ham,30,4,5,9,13,8,30,28,2,40
2802564,10/02/24,Manchester Reds,30,9,1,10,10,10,29,33,-4,40
2802564,10/02/24,Wolverhampton,30,3,7,10,9,11,34,31,3,39
2802564,10/02/24,Watford,30,3,6,9,10,11,33,40,-7,37
2802564,10/02/24,London Guns,30,4,5,9,9,12,45,47,-2,36
2802564,10/02/24,Everton,30,5,3,8,10,12,30,39,-9,34
2802564,10/02/24,Burnley,30,5,3,8,8,14,29,37,-8,32
2802564,10/02/24,Southampton,30,6,3,9,5,16,23,37,-14,32
2802564,10/02/24,Leicester,30,3,4,7,8,15,40,50,-10,29
2802564,10/02/24,Crystal Palace,30,3,3,6,7,17,30,51,-21,25
2802564,10/02/24,Newcastle,30,1,4,5,6,19,25,50,-25,21
2802590,10/02/24,Chelsea,30,9,3,12,10,8,38,32,6,46
2802590,10/02/24,Liverpool,30,9,5,14,9,7,45,34,11,51
2802590,10/02/24,Tottenham,30,11,6,17,5,8,50,27,23,56
2802590,10/02/24,Manchester Blue,30,11,8,19,5,6,62,26,36,62
2802590,10/02/24,Bournemouth,30,9,6,15,5,10,50,35,15,50
2802590,10/02/24,West Ham,30,7,2,9,7,14,36,48,-12,34
2802590,10/02/24,Manchester Reds,30,9,7,16,5,9,38,29,9,53
2802590,10/02/24,Wolverhampton,30,7,6,13,10,7,39,33,6,49
2802590,10/02/24,Watford,30,2,6,8,10,12,30,39,-9,34
2802590,10/02/24,London Guns,30,6,8,14,7,9,46,32,14,49
2802590,10/02/24,Everton,30,5,4,9,6,15,42,51,-9,33
2802590,10/02/24,Burnley,30,4,2,6,9,15,16,39,-23,27
2802590,10/02/24,Southampton,30,8,4,12,6,12,27,34,-7,42
2802590,10/02/24,Leicester,30,5,2,7,9,14,39,48,-9,30
2802590,10/02/24,Crystal Palace,30,2,2,4,6,20,22,53,-31,18
2802590,10/02/24,Newcastle,30,3,3,6,9,15,24,44,-20,27
2802615,10/02/24,Chelsea,30,10,6,16,9,5,55,26,29,57
2802615,10/02/24,Liverpool,30,10,6,16,5,9,53,28,25,53
2802615,10/02/24,Tottenham,30,11,6,17,4,9,58,41,17,55
2802615,10/02/24,Manchester Blue,30,11,8,19,5,6,52,21,31,62
2802615,10/02/24,Bournemouth,30,5,3,8,14,8,29,27,2,38
2802615,10/02/24,West Ham,30,9,4,13,7,10,41,43,-2,46
2802615,10/02/24,Manchester Reds,30,10,5,15,5,10,42,33,9,50
2802615,10/02/24,Wolverhampton,30,4,3,7,10,13,27,39,-12,31
2802615,10/02/24,Watford,30,4,1,5,8,17,23,49,-26,23
2802615,10/02/24,London Guns,30,9,6,15,8,7,48,28,20,53
2802615,10/02/24,Everton,30,6,3,9,9,12,34,39,-5,36
2802615,10/02/24,Burnley,30,5,4,9,8,13,25,45,-20,35
2802615,10/02/24,Southampton,30,6,4,10,5,15,29,37,-8,35
2802615,10/02/24,Leicester,30,6,6,12,5,13,41,48,-7,41
2802615,10/02/24,Crystal Palace,30,7,4,11,4,15,32,41,-9,37
2802615,10/02/24,Newcastle,30,2,1,3,4,23,13,57,-44,13
2802641,10/02/24,Chelsea,30,10,6,16,7,7,52,23,29,55
2802641,10/02/24,Liverpool,30,7,6,13,7,10,39,26,13,46
2802641,10/02/24,Tottenham,30,10,6,16,4,10,47,37,10,52
2802641,10/02/24,Manchester Blue,30,9,10,19,6,5,62,30,32,63
2802641,10/02/24,Bournemouth,30,7,5,12,7,11,45,35,10,43
2802641,10/02/24,West Ham,30,3,5,8,4,18,25,56,-31,28
2802641,10/02/24,Manchester Reds,30,12,8,20,5,5,58,21,37,65
2802641,10/02/24,Wolverhampton,30,9,6,15,9,6,34,21,13,54
2802641,10/02/24,Watford,30,6,4,10,2,18,33,50,-17,32
2802641,10/02/24,London Guns,30,8,6,14,6,10,47,43,4,48
2802641,10/02/24,Everton,30,5,2,7,10,13,34,47,-13,31
2802641,10/02/24,Burnley,30,5,4,9,11,10,21,34,-13,38
2802641,10/02/24,Southampton,30,3,3,6,5,19,25,45,-20,23
2802641,10/02/24,Leicester,30,5,5,10,6,14,33,44,-11,36
2802641,10/02/24,Crystal Palace,30,4,4,8,8,14,31,48,-17,32
2802641,10/02/24,Newcastle,30,3,3,6,5,19,27,53,-26,23
2802664,10/02/24,Chelsea,30,9,9,18,9,3,51,22,29,63
2802664,10/02/24,Liverpool,30,7,8,15,9,6,48,37,11,54
2802664,10/02/24,Tottenham,30,10,5,15,7,8,53,34,19,52
2802664,10/02/24,Manchester Blue,30,10,7,17,7,6,49,30,19,58
2802664,10/02/24,Bournemouth,30,9,5,14,8,8,43,30,13,50
2802664,10/02/24,West Ham,30,4,3,7,9,14,31,46,-15,30
2802664,10/02/24,Manchester Reds,30,10,2,12,8,10,41,31,10,44
2802664,10/02/24,Wolverhampton,30,4,5,9,12,9,38,39,-1,39
2802664,10/02/24,Watford,30,5,4,9,8,13,36,41,-5,35
2802664,10/02/24,London Guns,30,7,2,9,14,7,37,32,5,41
2802664,10/02/24,Everton,30,7,3,10,12,8,38,43,-5,42
2802664,10/02/24,Burnley,30,4,3,7,8,15,21,34,-13,29
2802664,10/02/24,Southampton,30,5,0,5,6,19,17,45,-28,21
2802664,10/02/24,Leicester,30,3,3,6,9,15,36,44,-8,27
2802664,10/02/24,Crystal Palace,30,3,2,5,13,12,25,42,-17,28
2802664,10/02/24,Newcastle,30,7,2,9,7,14,30,44,-14,34
2802692,10/02/24,Chelsea,30,9,8,17,6,7,43,29,14,57
2802692,10/02/24,Liverpool,30,11,5,16,8,6,55,29,26,56
2802692,10/02/24,Tottenham,30,7,7,14,9,7,52,38,14,51
2802692,10/02/24,Manchester Blue,30,10,7,17,9,4,64,29,35,60
2802692,10/02/24,Bournemouth,30,5,5,10,11,9,33,26,7,41
2802692,10/02/24,West Ham,30,6,4,10,8,12,40,50,-10,38
2802692,10/02/24,Manchester Reds,30,6,6,12,5,13,36,37,-1,41
2802692,10/02/24,Wolverhampton,30,8,5,13,7,10,40,35,5,46
2802692,10/02/24,Watford,30,8,6,14,9,7,49,38,11,51
2802692,10/02/24,London Guns,30,6,5,11,12,7,38,28,10,45
2802692,10/02/24,Everton,30,5,7,12,5,13,45,42,3,41
2802692,10/02/24,Burnley,30,6,2,8,9,13,22,34,-12,33
2802692,10/02/24,Southampton,30,1,2,3,9,18,23,53,-30,18
2802692,10/02/24,Leicester,30,3,3,6,10,14,33,59,-26,28
2802692,10/02/24,Crystal Palace,30,4,3,7,5,18,35,49,-14,26
2802692,10/02/24,Newcastle,30,3,3,6,6,18,21,53,-32,24
2802720,11/02/24,Chelsea,30,6,7,13,5,12,38,36,2,44
2802720,11/02/24,Liverpool,30,11,5,16,9,5,54,29,25,57
2802720,11/02/24,Tottenham,30,11,3,14,5,11,53,37,16,47
2802720,11/02/24,Manchester Blue,30,6,6,12,8,10,47,32,15,44
2802720,11/02/24,Bournemouth,30,10,6,16,6,8,42,29,13,54
2802720,11/02/24,West Ham,30,3,3,6,5,19,30,55,-25,23
2802720,11/02/24,Manchester Reds,30,9,9,18,8,4,47,18,29,62
2802720,11/02/24,Wolverhampton,30,7,2,9,5,16,30,43,-13,32
2802720,11/02/24,Watford,30,7,5,12,4,14,40,40,0,40
2802720,11/02/24,London Guns,30,10,9,19,6,5,59,30,29,63
2802720,11/02/24,Everton,30,7,4,11,8,11,38,44,-6,41
2802720,11/02/24,Burnley,30,2,4,6,9,15,19,41,-22,27
2802720,11/02/24,Southampton,30,2,5,7,8,15,37,56,-19,29
2802720,11/02/24,Leicester,30,9,4,13,4,13,49,51,-2,43
2802720,11/02/24,Crystal Palace,30,6,4,10,5,15,34,51,-17,35
2802720,11/02/24,Newcastle,30,7,1,8,5,17,31,56,-25,29
2802745,11/02/24,Chelsea,30,11,4,15,8,7,51,38,13,53
2802745,11/02/24,Liverpool,30,8,3,11,9,10,39,37,2,42
2802745,11/02/24,Tottenham,30,7,3,10,7,13,41,46,-5,37
2802745,11/02/24,Manchester Blue,30,8,10,18,3,9,55,32,23,57
2802745,11/02/24,Bournemouth,30,6,8,14,8,8,38,21,17,50
2802745,11/02/24,West Ham,30,6,4,10,7,13,35,47,-12,37
2802745,11/02/24,Manchester Reds,30,7,3,10,9,11,38,36,2,39
2802745,11/02/24,Wolverhampton,30,9,4,13,8,9,30,28,2,47
2802745,11/02/24,Watford,30,3,5,8,9,13,33,41,-8,33
2802745,11/02/24,London Guns,30,13,7,20,4,6,60,28,32,64
2802745,11/02/24,Everton,30,12,3,15,6,9,51,34,17,51
2802745,11/02/24,Burnley,30,5,4,9,9,12,29,33,-4,36
2802745,11/02/24,Southampton,30,3,3,6,5,19,27,50,-23,23
2802745,11/02/24,Leicester,30,7,6,13,6,11,41,41,0,45
2802745,11/02/24,Crystal Palace,30,5,2,7,8,15,26,41,-15,29
2802745,11/02/24,Newcastle,30,3,2,5,6,19,20,61,-41,21
2802769,11/02/24,Chelsea,30,8,9,17,5,8,48,29,19,56
2802769,11/02/24,Liverpool,30,9,7,16,5,9,45,27,18,53
2802769,11/02/24,Tottenham,30,7,6,13,7,10,41,34,7,46
2802769,11/02/24,Manchester Blue,30,8,10,18,6,6,53,24,29,60
2802769,11/02/24,Bournemouth,30,7,5,12,4,14,32,38,-6,40
2802769,11/02/24,West Ham,30,3,4,7,5,18,29,48,-19,26
2802769,11/02/24,Manchester Reds,30,10,6,16,6,8,48,29,19,54
2802769,11/02/24,Wolverhampton,30,4,2,6,11,13,27,33,-6,29
2802769,11/02/24,Watford,30,5,2,7,10,13,27,42,-15,31
2802769,11/02/24,London Guns,30,11,6,17,9,4,62,33,29,60
2802769,11/02/24,Everton,30,7,5,12,8,10,40,42,-2,44
2802769,11/02/24,Burnley,30,5,5,10,6,14,25,35,-10,36
2802769,11/02/24,Southampton,30,4,7,11,7,12,25,35,-10,40
2802769,11/02/24,Leicester,30,6,3,9,5,16,48,64,-16,32
2802769,11/02/24,Crystal Palace,30,4,1,5,10,15,30,60,-30,25
2802769,11/02/24,Newcastle,30,6,3,9,6,15,33,40,-7,33
2802795,11/02/24,Chelsea,30,9,6,15,9,6,45,26,19,54
2802795,11/02/24,Liverpool,30,10,9,19,5,6,52,31,21,62
2802795,11/02/24,Tottenham,30,13,4,17,4,9,56,35,21,55
2802795,11/02/24,Manchester Blue,30,8,6,14,4,12,53,38,15,46
2802795,11/02/24,Bournemouth,30,8,7,15,9,6,52,33,19,54
2802795,11/02/24,West Ham,30,5,5,10,4,16,37,50,-13,34
2802795,11/02/24,Manchester Reds,30,10,4,14,7,9,45,40,5,49
2802795,11/02/24,Wolverhampton,30,7,8,15,4,11,40,32,8,49
2802795,11/02/24,Watford,30,6,5,11,7,12,33,35,-2,40
2802795,11/02/24,London Guns,30,10,7,17,7,6,58,33,25,58
2802795,11/02/24,Everton,30,6,1,7,8,15,28,45,-17,29
2802795,11/02/24,Burnley,30,3,3,6,9,15,23,41,-18,27
2802795,11/02/24,Southampton,30,3,1,4,9,17,21,43,-22,21
2802795,11/02/24,Leicester,30,6,5,11,7,12,38,52,-14,40
2802795,11/02/24,Crystal Palace,30,4,2,6,6,18,34,55,-21,24
2802795,11/02/24,Newcastle,30,3,3,6,7,17,24,50,-26,25
2802820,11/02/24,Chelsea,30,5,4,9,13,8,32,31,1,40
2802820,11/02/24,Liverpool,30,11,8,19,7,4,57,26,31,64
2802820,11/02/24,Tottenham,30,8,3,11,9,10,46,39,7,42
2802820,11/02/24,Manchester Blue,30,8,7,15,10,5,46,26,20,55
2802820,11/02/24,Bournemouth,30,8,6,14,4,12,44,37,7,46
2802820,11/02/24,West Ham,30,2,4,6,8,16,30,49,-19,26
2802820,11/02/24,Manchester Reds,30,7,4,11,10,9,37,29,8,43
2802820,11/02/24,Wolverhampton,30,6,4,10,9,11,36,33,3,39
2802820,11/02/24,Watford,30,5,7,12,10,8,33,35,-2,46
2802820,11/02/24,London Guns,30,8,8,16,5,9,49,35,14,53
2802820,11/02/24,Everton,30,5,6,11,9,10,43,39,4,42
2802820,11/02/24,Burnley,30,3,3,6,7,17,20,47,-27,25
2802820,11/02/24,Southampton,30,3,3,6,9,15,19,34,-15,27
2802820,11/02/24,Leicester,30,7,4,11,10,9,50,42,8,43
2802820,11/02/24,Crystal Palace,30,5,3,8,9,13,33,48,-15,33
2802820,11/02/24,Newcastle,30,5,3,8,5,17,31,56,-25,29
2802845,11/02/24,Chelsea,30,11,9,20,5,5,56,28,28,65
2802845,11/02/24,Liverpool,30,9,4,13,6,11,44,40,4,45
2802845,11/02/24,Tottenham,30,10,6,16,9,5,50,24,26,57
2802845,11/02/24,Manchester Blue,30,7,8,15,13,2,52,24,28,58
2802845,11/02/24,Bournemouth,30,5,5,10,11,9,44,42,2,41
2802845,11/02/24,West Ham,30,4,2,6,4,20,26,59,-33,22
2802845,11/02/24,Manchester Reds,30,6,7,13,7,10,46,36,10,46
2802845,11/02/24,Wolverhampton,30,8,5,13,7,10,42,33,9,46
2802845,11/02/24,Watford,30,6,7,13,7,10,42,38,4,46
2802845,11/02/24,London Guns,30,7,7,14,8,8,53,32,21,50
2802845,11/02/24,Everton,30,10,3,13,3,14,45,48,-3,42
2802845,11/02/24,Burnley,30,4,7,11,10,9,33,29,4,43
2802845,11/02/24,Southampton,30,7,2,9,4,17,31,51,-20,31
2802845,11/02/24,Leicester,30,8,2,10,6,14,45,51,-6,36
2802845,11/02/24,Crystal Palace,30,3,0,3,10,17,25,57,-32,19
2802845,11/02/24,Newcastle,30,2,2,4,4,22,19,61,-42,16
2802874,11/02/24,Chelsea,30,8,8,16,9,5,46,27,19,57
2802874,11/02/24,Liverpool,30,8,12,20,6,4,63,26,37,66
2802874,11/02/24,Tottenham,30,8,6,14,3,13,53,44,9,45
2802874,11/02/24,Manchester Blue,30,9,6,15,7,8,52,36,16,52
2802874,11/02/24,Bournemouth,30,10,4,14,8,8,44,35,9,50
2802874,11/02/24,West Ham,30,2,2,4,10,16,24,44,-20,22
2802874,11/02/24,Manchester Reds,30,8,6,14,5,11,38,31,7,47
2802874,11/02/24,Wolverhampton,30,2,3,5,8,17,29,49,-20,23
2802874,11/02/24,Watford,30,5,6,11,10,9,42,41,1,43
2802874,11/02/24,London Guns,30,11,9,20,4,6,67,35,32,64
2802874,11/02/24,Everton,30,8,5,13,6,11,47,45,2,45
2802874,11/02/24,Burnley,30,4,2,6,9,15,25,40,-15,27
2802874,11/02/24,Southampton,30,4,3,7,7,16,30,49,-19,28
2802874,11/02/24,Leicester,30,5,5,10,5,15,41,57,-16,35
2802874,11/02/24,Crystal Palace,30,6,1,7,10,13,30,48,-18,31
2802874,11/02/24,Newcastle,30,4,4,8,5,17,28,52,-24,29
2802902,11/02/24,Chelsea,30,6,8,14,9,7,55,34,21,51
2802902,11/02/24,Liverpool,30,9,7,16,8,6,57,32,25,56
2802902,11/02/24,Tottenham,30,5,8,13,8,9,46,36,10,47
2802902,11/02/24,Manchester Blue,30,10,6,16,7,7,60,40,20,55
2802902,11/02/24,Bournemouth,30,6,8,14,8,8,40,28,12,50
2802902,11/02/24,West Ham,30,2,1,3,8,19,27,57,-30,17
2802902,11/02/24,Manchester Reds,30,9,5,14,8,8,48,39,9,50
2802902,11/02/24,Wolverhampton,30,7,5,12,6,12,35,34,1,42
2802902,11/02/24,Watford,30,7,3,10,7,13,34,33,1,37
2802902,11/02/24,London Guns,30,7,7,14,6,10,46,37,9,48
2802902,11/02/24,Everton,30,10,10,20,6,4,54,36,18,66
2802902,11/02/24,Burnley,30,3,3,6,5,19,18,40,-22,23
2802902,11/02/24,Southampton,30,5,3,8,7,15,28,37,-9,31
2802902,11/02/24,Leicester,30,6,4,10,8,12,42,55,-13,38
2802902,11/02/24,Crystal Palace,30,2,2,4,8,18,26,59,-33,20
2802902,11/02/24,Newcastle,30,5,2,7,9,14,32,51,-19,30
2802925,11/02/24,Chelsea,30,10,3,13,6,11,37,36,1,45
2802925,11/02/24,Liverpool,30,9,7,16,8,6,50,29,21,56
2802925,11/02/24,Tottenham,30,8,5,13,10,7,41,29,12,49
2802925,11/02/24,Manchester Blue,30,10,5,15,9,6,51,36,15,54
2802925,11/02/24,Bournemouth,30,8,4,12,6,12,41,28,13,42
2802925,11/02/24,West Ham,30,8,2,10,10,10,38,36,2,40
2802925,11/02/24,Manchester Reds,30,11,6,17,3,10,47,30,17,54
2802925,11/02/24,Wolverhampton,30,6,4,10,11,9,33,35,-2,41
2802925,11/02/24,Watford,30,2,7,9,9,12,34,42,-8,36
2802925,11/02/24,London Guns,30,9,9,18,6,6,50,27,23,60
2802925,11/02/24,Everton,30,7,4,11,9,10,52,48,4,42
2802925,11/02/24,Burnley,30,3,5,8,4,18,24,48,-24,28
2802925,11/02/24,Southampton,30,7,0,7,6,17,23,39,-16,27
2802925,11/02/24,Leicester,30,6,4,10,5,15,36,44,-8,35
2802925,11/02/24,Crystal Palace,30,5,1,6,5,19,29,52,-23,23
2802925,11/02/24,Newcastle,30,6,2,8,7,15,28,55,-27,31
2802952,11/02/24,Chelsea,30,7,4,11,12,7,48,36,12,45
2802952,11/02/24,Liverpool,30,10,10,20,6,4,61,23,38,66
2802952,11/02/24,Tottenham,30,5,5,10,12,8,49,50,-1,42
2802952,11/02/24,Manchester Blue,30,11,6,17,8,5,55,29,26,59
2802952,11/02/24,Bournemouth,30,10,4,14,7,9,42,29,13,49
2802952,11/02/24,West Ham,30,3,3,6,8,16,26,38,-12,26
2802952,11/02/24,Manchester Reds,30,5,9,14,7,9,44,40,4,49
2802952,11/02/24,Wolverhampton,30,4,5,9,9,12,28,34,-6,36
2802952,11/02/24,Watford,30,6,4,10,9,11,32,38,-6,39
2802952,11/02/24,London Guns,30,7,7,14,7,9,55,36,19,49
2802952,11/02/24,Everton,30,4,8,12,9,9,40,43,-3,45
2802952,11/02/24,Burnley,30,3,2,5,10,15,26,49,-23,25
2802952,11/02/24,Southampton,30,5,1,6,8,16,24,49,-25,26
2802952,11/02/24,Leicester,30,7,1,8,7,15,46,51,-5,31
2802952,11/02/24,Crystal Palace,30,6,3,9,6,15,37,51,-14,33
2802952,11/02/24,Newcastle,30,6,2,8,9,13,31,48,-17,33
2802977,11/02/24,Chelsea,30,10,12,22,4,4,61,22,39,70
2802977,11/02/24,Liverpool,30,10,5,15,8,7,58,42,16,53
2802977,11/02/24,Tottenham,30,8,7,15,9,6,46,32,14,54
2802977,11/02/24,Manchester Blue,30,7,9,16,11,3,47,21,26,59
2802977,11/02/24,Bournemouth,30,4,5,9,11,10,29,30,-1,38
2802977,11/02/24,West Ham,30,5,1,6,11,13,32,47,-15,29
2802977,11/02/24,Manchester Reds,30,8,9,17,4,9,49,35,14,55
2802977,11/02/24,Wolverhampton,30,7,4,11,7,12,30,30,0,40
2802977,11/02/24,Watford,30,7,4,11,5,14,38,39,-1,38
2802977,11/02/24,London Guns,30,8,8,16,8,6,52,35,17,56
2802977,11/02/24,Everton,30,8,3,11,8,11,43,42,1,41
2802977,11/02/24,Burnley,30,3,3,6,9,15,27,42,-15,27
2802977,11/02/24,Southampton,30,2,2,4,7,19,29,54,-25,19
2802977,11/02/24,Leicester,30,5,4,9,5,16,31,54,-23,32
2802977,11/02/24,Crystal Palace,30,4,0,4,8,18,24,49,-25,20
2802977,11/02/24,Newcastle,30,1,5,6,9,15,24,46,-22,27
2803001,11/02/24,Chelsea,30,8,6,14,3,13,44,39,5,45
2803001,11/02/24,Liverpool,30,10,7,17,6,7,55,33,22,57
2803001,11/02/24,Tottenham,30,10,8,18,3,9,63,38,25,57
2803001,11/02/24,Manchester Blue,30,11,10,21,4,5,59,26,33,67
2803001,11/02/24,Bournemouth,30,6,7,13,6,11,30,28,2,45
2803001,11/02/24,West Ham,30,5,5,10,3,17,29,49,-20,33
2803001,11/02/24,Manchester Reds,30,8,5,13,11,6,43,29,14,50
2803001,11/02/24,Wolverhampton,30,8,8,16,6,8,46,28,18,54
2803001,11/02/24,Watford,30,9,2,11,7,12,41,45,-4,40
2803001,11/02/24,London Guns,30,6,8,14,9,7,41,28,13,51
2803001,11/02/24,Everton,30,9,5,14,3,13,44,45,-1,45
2803001,11/02/24,Burnley,30,3,5,8,9,13,21,35,-14,33
2803001,11/02/24,Southampton,30,4,3,7,6,17,23,44,-21,27
2803001,11/02/24,Leicester,30,4,2,6,10,14,29,41,-12,28
2803001,11/02/24,Crystal Palace,30,4,1,5,6,19,26,54,-28,21
2803001,11/02/24,Newcastle,30,5,1,6,2,22,22,54,-32,20
2803026,11/02/24,Chelsea,30,11,4,15,5,10,46,26,20,50
2803026,11/02/24,Liverpool,30,8,7,15,8,7,46,28,18,53
2803026,11/02/24,Tottenham,30,11,7,18,5,7,48,31,17,59
2803026,11/02/24,Manchester Blue,30,9,6,15,3,12,51,38,13,48
2803026,11/02/24,Bournemouth,30,9,6,15,6,9,48,33,15,51
2803026,11/02/24,West Ham,30,5,2,7,11,12,26,43,-17,32
2803026,11/02/24,Manchester Reds,30,9,5,14,8,8,55,36,19,50
2803026,11/02/24,Wolverhampton,30,5,3,8,9,13,27,37,-10,33
2803026,11/02/24,Watford,30,8,5,13,9,8,45,40,5,48
2803026,11/02/24,London Guns,30,8,7,15,7,8,50,32,18,52
2803026,11/02/24,Everton,30,7,4,11,5,14,46,44,2,38
2803026,11/02/24,Burnley,30,6,2,8,6,16,25,38,-13,30
2803026,11/02/24,Southampton,30,2,1,3,12,15,19,45,-26,21
2803026,11/02/24,Leicester,30,5,2,7,10,13,33,54,-21,31
2803026,11/02/24,Crystal Palace,30,7,3,10,7,13,31,54,-23,37
2803026,11/02/24,Newcastle,30,4,4,8,5,17,33,50,-17,29
2803056,12/02/24,Chelsea,30,7,8,15,8,7,56,29,27,53
2803056,12/02/24,Liverpool,30,7,7,14,10,6,56,30,26,52
2803056,12/02/24,Tottenham,30,12,5,17,7,6,61,33,28,58
2803056,12/02/24,Manchester Blue,30,10,6,16,6,8,45,29,16,54
2803056,12/02/24,Bournemouth,30,10,7,17,7,6,47,24,23,58
2803056,12/02/24,West Ham,30,6,2,8,6,16,34,50,-16,30
2803056,12/02/24,Manchester Reds,30,10,5,15,7,8,39,34,5,52
2803056,12/02/24,Wolverhampton,30,5,3,8,10,12,26,35,-9,34
2803056,12/02/24,Watford,30,4,2,6,12,12,23,42,-19,30
2803056,12/02/24,London Guns,30,9,5,14,8,8,46,37,9,50
2803056,12/02/24,Everton,30,4,3,7,10,13,38,48,-10,31
2803056,12/02/24,Burnley,30,5,4,9,9,12,23,39,-16,36
2803056,12/02/24,Southampton,30,3,3,6,10,14,27,46,-19,28
2803056,12/02/24,Leicester,30,7,3,10,7,13,46,48,-2,37
2803056,12/02/24,Crystal Palace,30,5,4,9,5,16,34,52,-18,32
2803056,12/02/24,Newcastle,30,4,1,5,6,19,32,57,-25,21
2803079,12/02/24,Chelsea,30,9,5,14,5,11,44,37,7,47
2803079,12/02/24,Liverpool,30,10,8,18,9,3,47,18,29,63
2803079,12/02/24,Tottenham,30,11,6,17,4,9,47,30,17,55
2803079,12/02/24,Manchester Blue,30,10,6,16,3,11,51,35,16,51
2803079,12/02/24,Bournemouth,30,9,8,17,7,6,50,26,24,58
2803079,12/02/24,West Ham,30,7,5,12,5,13,36,45,-9,41
2803079,12/02/24,Manchester Reds,30,8,8,16,7,7,52,31,21,55
2803079,12/02/24,Wolverhampton,30,3,5,8,10,12,25,36,-11,34
2803079,12/02/24,Watford,30,7,3,10,8,12,33,45,-12,38
2803079,12/02/24,London Guns,30,8,4,12,7,11,49,35,14,43
2803079,12/02/24,Everton,30,7,7,14,4,12,48,38,10,46
2803079,12/02/24,Burnley,30,5,1,6,9,15,29,44,-15,27
2803079,12/02/24,Southampton,30,3,1,4,11,15,24,48,-24,23
2803079,12/02/24,Leicester,30,7,2,9,6,15,31,49,-18,33
2803079,12/02/24,Crystal Palace,30,5,1,6,7,17,31,54,-23,25
2803079,12/02/24,Newcastle,30,4,2,6,8,16,24,50,-26,26
2803107,12/02/24,Chelsea,30,10,11,21,4,5,57,24,33,67
2803107,12/02/24,Liverpool,30,9,8,17,5,8,44,27,17,56
2803107,12/02/24,Tottenham,30,7,4,11,7,12,44,46,-2,40
2803107,12/02/24,Manchester Blue,30,11,5,16,6,8,59,40,19,54
2803107,12/02/24,Bournemouth,30,9,4,13,10,7,37,27,10,49
2803107,12/02/24,West Ham,30,6,2,8,6,16,36,48,-12,30
2803107,12/02/24,Manchester Reds,30,10,8,18,5,7,41,24,17,59
2803107,12/02/24,Wolverhampton,30,7,6,13,6,11,33,36,-3,45
2803107,12/02/24,Watford,30,7,2,9,3,18,35,50,-15,30
2803107,12/02/24,London Guns,30,12,7,19,7,4,61,19,42,64
2803107,12/02/24,Everton,30,4,3,7,5,18,29,42,-13,26
2803107,12/02/24,Burnley,30,5,4,9,7,14,24,31,-7,34
2803107,12/02/24,Southampton,30,3,3,6,12,12,17,40,-23,30
2803107,12/02/24,Leicester,30,7,3,10,7,13,33,39,-6,37
2803107,12/02/24,Crystal Palace,30,3,4,7,4,19,26,52,-26,25
2803107,12/02/24,Newcastle,30,4,2,6,6,18,21,52,-31,24
2803131,12/02/24,Chelsea,30,9,8,17,9,4,57,31,26,60
2803131,12/02/24,Liverpool,30,10,8,18,2,10,50,28,22,56
2803131,12/02/24,Tottenham,30,6,4,10,7,13,39,36,3,37
2803131,12/02/24,Manchester Blue,30,13,9,22,4,4,54,29,25,70
2803131,12/02/24,Bournemouth,30,6,6,12,9,9,33,25,8,45
2803131,12/02/24,West Ham,30,8,2,10,8,12,32,35,-3,38
2803131,12/02/24,Manchester Reds,30,10,8,18,5,7,51,35,16,59
2803131,12/02/24,Wolverhampton,30,7,4,11,7,12,32,30,2,40
2803131,12/02/24,Watford,30,6,5,11,5,14,29,41,-12,38
2803131,12/02/24,London Guns,30,5,8,13,7,10,40,29,11,46
2803131,12/02/24,Everton,30,6,3,9,8,13,35,44,-9,35
2803131,12/02/24,Burnley,30,3,5,8,8,14,28,40,-12,32
2803131,12/02/24,Southampton,30,4,1,5,10,15,24,41,-17,25
2803131,12/02/24,Leicester,30,6,3,9,6,15,33,51,-18,33
2803131,12/02/24,Crystal Palace,30,4,3,7,9,14,42,53,-11,30
2803131,12/02/24,Newcastle,30,3,1,4,8,18,23,54,-31,20
2803156,12/02/24,Chelsea,30,10,9,19,6,5,45,19,26,63
2803156,12/02/24,Liverpool,30,10,9,19,7,4,61,23,38,64
2803156,12/02/24,Tottenham,30,10,4,14,3,13,44,38,6,45
2803156,12/02/24,Manchester Blue,30,9,7,16,5,9,64,34,30,53
2803156,12/02/24,Bournemouth,30,7,6,13,10,7,33,23,10,49
2803156,12/02/24,West Ham,30,3,5,8,9,13,30,37,-7,33
2803156,12/02/24,Manchester Reds,30,6,7,13,6,11,44,29,15,45
2803156,12/02/24,Wolverhampton,30,6,5,11,14,5,27,21,6,47
2803156,12/02/24,Watford,30,4,6,10,8,12,33,39,-6,38
2803156,12/02/24,London Guns,30,9,9,18,3,9,65,40,25,57
2803156,12/02/24,Everton,30,4,2,6,11,13,36,51,-15,29
2803156,12/02/24,Burnley,30,3,3,6,10,14,20,41,-21,28
2803156,12/02/24,Southampton,30,2,3,5,8,17,23,55,-32,23
2803156,12/02/24,Leicester,30,4,6,10,6,14,37,52,-15,36
2803156,12/02/24,Crystal Palace,30,4,4,8,2,20,34,73,-39,26
2803156,12/02/24,Newcastle,30,5,2,7,6,17,31,52,-21,27
2803180,12/02/24,Chelsea,30,10,4,14,11,5,53,28,25,53
2803180,12/02/24,Liverpool,30,9,9,18,9,3,45,21,24,63
2803180,12/02/24,Tottenham,30,7,6,13,8,9,45,36,9,47
2803180,12/02/24,Manchester Blue,30,5,8,13,8,9,51,37,14,47
2803180,12/02/24,Bournemouth,30,10,5,15,6,9,41,33,8,51
2803180,12/02/24,West Ham,30,4,2,6,8,16,30,50,-20,26
2803180,12/02/24,Manchester Reds,30,5,8,13,6,11,45,34,11,45
2803180,12/02/24,Wolverhampton,30,6,3,9,11,10,35,36,-1,38
2803180,12/02/24,Watford,30,3,7,10,6,14,39,40,-1,36
2803180,12/02/24,London Guns,30,9,9,18,8,4,53,16,37,62
2803180,12/02/24,Everton,30,7,5,12,0,18,37,49,-12,36
2803180,12/02/24,Burnley,30,5,3,8,7,15,20,40,-20,31
2803180,12/02/24,Southampton,30,3,4,7,7,16,23,45,-22,28
2803180,12/02/24,Leicester,30,6,4,10,5,15,29,47,-18,35
2803180,12/02/24,Crystal Palace,30,4,4,8,7,15,32,48,-16,31
2803180,12/02/24,Newcastle,30,5,5,10,5,15,27,45,-18,35
2803211,12/02/24,Chelsea,30,7,7,14,9,7,40,31,9,51
2803211,12/02/24,Liverpool,30,7,6,13,10,7,38,25,13,49
2803211,12/02/24,Tottenham,30,7,6,13,10,7,50,34,16,49
2803211,12/02/24,Manchester Blue,30,9,5,14,10,6,59,30,29,52
2803211,12/02/24,Bournemouth,30,5,7,12,14,4,53,34,19,50
2803211,12/02/24,West Ham,30,2,3,5,7,18,21,51,-30,22
2803211,12/02/24,Manchester Reds,30,6,8,14,8,8,49,33,16,50
2803211,12/02/24,Wolverhampton,30,5,4,9,10,11,32,29,3,37
2803211,12/02/24,Watford,30,3,4,7,7,16,27,50,-23,28
2803211,12/02/24,London Guns,30,9,10,19,6,5,51,31,20,63
2803211,12/02/24,Everton,30,3,4,7,10,13,32,43,-11,31
2803211,12/02/24,Burnley,30,4,2,6,12,12,24,34,-10,30
2803211,12/02/24,Southampton,30,4,5,9,4,17,29,48,-19,31
2803211,12/02/24,Leicester,30,5,6,11,9,10,45,45,0,42
2803211,12/02/24,Crystal Palace,30,9,2,11,3,16,33,44,-11,36
2803211,12/02/24,Newcastle,30,3,5,8,7,15,25,46,-21,31
2803233,12/02/24,Chelsea,30,7,7,14,7,9,43,32,11,49
2803233,12/02/24,Liverpool,30,7,8,15,5,10,38,32,6,50
2803233,12/02/24,Tottenham,30,11,5,16,8,6,57,38,19,56
2803233,12/02/24,Manchester Blue,30,7,8,15,3,12,50,32,18,48
2803233,12/02/24,Bournemouth,30,9,6,15,10,5,47,23,24,55
2803233,12/02/24,West Ham,30,5,3,8,7,15,26,41,-15,31
2803233,12/02/24,Manchester Reds,30,8,7,15,7,8,41,34,7,52
2803233,12/02/24,Wolverhampton,30,5,6,11,8,11,32,33,-1,41
2803233,12/02/24,Watford,30,6,6,12,4,14,37,45,-8,40
2803233,12/02/24,London Guns,30,8,10,18,5,7,45,23,22,59
2803233,12/02/24,Everton,30,7,5,12,7,11,39,34,5,43
2803233,12/02/24,Burnley,30,4,2,6,5,19,27,44,-17,23
2803233,12/02/24,Southampton,30,4,3,7,8,15,25,45,-20,29
2803233,12/02/24,Leicester,30,7,4,11,7,12,50,48,2,40
2803233,12/02/24,Crystal Palace,30,3,1,4,8,18,23,57,-34,20
2803233,12/02/24,Newcastle,30,5,4,9,5,16,39,58,-19,32
2803260,12/02/24,Chelsea,30,10,4,14,9,7,39,25,14,51
2803260,12/02/24,Liverpool,30,7,5,12,10,8,35,28,7,46
2803260,12/02/24,Tottenham,30,9,4,13,7,10,40,31,9,46
2803260,12/02/24,Manchester Blue,30,13,9,22,5,3,66,21,45,71
2803260,12/02/24,Bournemouth,30,9,5,14,9,7,43,30,13,51
2803260,12/02/24,West Ham,30,4,2,6,7,17,26,51,-25,25
2803260,12/02/24,Manchester Reds,30,8,4,12,9,9,35,30,5,45
2803260,12/02/24,Wolverhampton,30,9,4,13,6,11,33,29,4,45
2803260,12/02/24,Watford,30,2,3,5,8,17,19,46,-27,23
2803260,12/02/24,London Guns,30,8,3,11,10,9,37,36,1,43
2803260,12/02/24,Everton,30,9,6,15,6,9,48,34,14,51
2803260,12/02/24,Burnley,30,9,3,12,5,13,29,30,-1,41
2803260,12/02/24,Southampton,30,6,3,9,7,14,22,35,-13,34
2803260,12/02/24,Leicester,30,4,2,6,8,16,32,48,-16,26
2803260,12/02/24,Crystal Palace,30,5,4,9,6,15,31,43,-12,33
2803260,12/02/24,Newcastle,30,6,1,7,8,15,20,38,-18,29
2803283,12/02/24,Chelsea,30,10,9,19,6,5,52,28,24,63
2803283,12/02/24,Liverpool,30,11,7,18,3,9,58,34,24,57
2803283,12/02/24,Tottenham,30,7,6,13,8,9,50,37,13,47
2803283,12/02/24,Manchester Blue,30,6,5,11,8,11,41,40,1,41
2803283,12/02/24,Bournemouth,30,6,5,11,8,11,39,37,2,41
2803283,12/02/24,West Ham,30,7,2,9,3,18,30,47,-17,30
2803283,12/02/24,Manchester Reds,30,7,6,13,9,8,45,31,14,48
2803283,12/02/24,Wolverhampton,30,6,3,9,6,15,32,44,-12,33
2803283,12/02/24,Watford,30,8,4,12,8,10,38,45,-7,44
2803283,12/02/24,London Guns,30,10,5,15,10,5,48,33,15,55
2803283,12/02/24,Everton,30,4,4,8,16,6,40,40,0,40
2803283,12/02/24,Burnley,30,3,2,5,5,20,22,48,-26,20
2803283,12/02/24,Southampton,30,4,2,6,6,18,28,44,-16,24
2803283,12/02/24,Leicester,30,5,6,11,8,11,43,49,-6,41
2803283,12/02/24,Crystal Palace,30,6,4,10,8,12,39,40,-1,38
2803283,12/02/24,Newcastle,30,4,5,9,10,11,31,39,-8,37
2803313,12/02/24,Chelsea,30,8,5,13,4,13,41,39,2,43
2803313,12/02/24,Liverpool,30,7,8,15,6,9,52,27,25,51
2803313,12/02/24,Tottenham,30,11,7,18,5,7,53,29,24,59
2803313,12/02/24,Manchester Blue,30,8,7,15,7,8,56,33,23,52
2803313,12/02/24,Bournemouth,30,6,7,13,10,7,42,28,14,49
2803313,12/02/24,West Ham,30,5,2,7,7,16,26,42,-16,28
2803313,12/02/24,Manchester Reds,30,9,8,17,8,5,48,31,17,59
2803313,12/02/24,Wolverhampton,30,6,3,9,10,11,33,35,-2,37
2803313,12/02/24,Watford,30,5,4,9,8,13,31,42,-11,35
2803313,12/02/24,London Guns,30,10,10,20,4,6,65,23,42,64
2803313,12/02/24,Everton,30,6,5,11,10,9,47,44,3,43
2803313,12/02/24,Burnley,30,5,4,9,8,13,28,46,-18,35
2803313,12/02/24,Southampton,30,3,4,7,8,15,21,48,-27,29
2803313,12/02/24,Leicester,30,8,1,9,6,15,30,44,-14,33
2803313,12/02/24,Crystal Palace,30,6,1,7,5,18,32,59,-27,26
2803313,12/02/24,Newcastle,30,0,5,5,6,19,21,56,-35,21
2803335,12/02/24,Chelsea,30,7,7,14,8,8,45,31,14,50
2803335,12/02/24,Liverpool,30,12,11,23,5,2,62,14,48,74
2803335,12/02/24,Tottenham,30,9,5,14,7,9,46,36,10,49
2803335,12/02/24,Manchester Blue,30,10,9,19,6,5,59,30,29,63
2803335,12/02/24,Bournemouth,30,7,7,14,7,9,33,24,9,49
2803335,12/02/24,West Ham,30,4,6,10,8,12,33,36,-3,38
2803335,12/02/24,Manchester Reds,30,8,5,13,13,4,39,30,9,52
2803335,12/02/24,Wolverhampton,30,5,4,9,13,8,35,31,4,40
2803335,12/02/24,Watford,30,3,6,9,8,13,26,39,-13,35
2803335,12/02/24,London Guns,30,9,9,18,3,9,49,31,18,57
2803335,12/02/24,Everton,30,6,5,11,2,17,34,49,-15,35
2803335,12/02/24,Burnley,30,4,3,7,6,17,24,41,-17,27
2803335,12/02/24,Southampton,30,3,2,5,5,20,19,52,-33,20
2803335,12/02/24,Leicester,30,3,1,4,5,21,31,56,-25,17
2803335,12/02/24,Crystal Palace,30,4,4,8,4,18,31,58,-27,28
2803335,12/02/24,Newcastle,30,3,5,8,8,14,34,42,-8,32
2803361,13/02/24,Chelsea,30,5,9,14,8,8,47,29,18,50
2803361,13/02/24,Liverpool,30,11,8,19,6,5,64,26,38,63
2803361,13/02/24,Tottenham,30,10,6,16,8,6,53,40,13,56
2803361,13/02/24,Manchester Blue,30,9,6,15,8,7,53,41,12,53
2803361,13/02/24,Bournemouth,30,9,7,16,7,7,51,31,20,55
2803361,13/02/24,West Ham,30,4,2,6,7,17,25,42,-17,25
2803361,13/02/24,Manchester Reds,30,8,6,14,7,9,41,37,4,49
2803361,13/02/24,Wolverhampton,30,4,5,9,7,14,25,29,-4,34
2803361,13/02/24,Watford,30,5,4,9,11,10,36,43,-7,38
2803361,13/02/24,London Guns,30,7,8,15,8,7,57,38,19,53
2803361,13/02/24,Everton,30,6,3,9,7,14,38,47,-9,34
2803361,13/02/24,Burnley,30,6,3,9,3,18,27,44,-17,30
2803361,13/02/24,Southampton,30,6,5,11,5,14,36,43,-7,38
2803361,13/02/24,Leicester,30,7,2,9,7,14,40,54,-14,34
2803361,13/02/24,Crystal Palace,30,4,2,6,5,19,26,53,-27,23
2803361,13/02/24,Newcastle,30,7,1,8,6,16,25,47,-22,30
2803388,13/02/24,Chelsea,30,6,6,12,8,10,45,38,7,44
2803388,13/02/24,Liverpool,30,9,11,20,6,4,64,23,41,66
2803388,13/02/24,Tottenham,30,9,5,14,5,11,43,36,7,47
2803388,13/02/24,Manchester Blue,30,10,7,17,10,3,56,27,29,61
2803388,13/02/24,Bournemouth,30,10,5,15,9,6,43,28,15,54
2803388,13/02/24,West Ham,30,3,5,8,4,18,29,53,-24,28
2803388,13/02/24,Manchester Reds,30,11,7,18,4,8,45,28,17,58
2803388,13/02/24,Wolverhampton,30,4,3,7,6,17,26,40,-14,27
2803388,13/02/24,Watford,30,6,8,14,8,8,40,34,6,50
2803388,13/02/24,London Guns,30,7,4,11,8,11,47,43,4,41
2803388,13/02/24,Everton,30,7,8,15,6,9,44,37,7,51
2803388,13/02/24,Burnley,30,3,3,6,14,10,24,35,-11,32
2803388,13/02/24,Southampton,30,4,1,5,5,20,21,57,-36,20
2803388,13/02/24,Leicester,30,2,1,3,7,20,30,49,-19,16
2803388,13/02/24,Crystal Palace,30,4,3,7,8,15,30,49,-19,29
2803388,13/02/24,Newcastle,30,7,3,10,8,12,29,39,-10,38
2803414,13/02/24,Chelsea,30,10,10,20,7,3,57,21,36,67
2803414,13/02/24,Liverpool,30,6,4,10,9,11,41,40,1,39
2803414,13/02/24,Tottenham,30,8,7,15,8,7,52,36,16,53
2803414,13/02/24,Manchester Blue,30,10,2,12,9,9,53,46,7,45
2803414,13/02/24,Bournemouth,30,7,7,14,9,7,44,28,16,51
2803414,13/02/24,West Ham,30,6,4,10,6,14,30,52,-22,36
2803414,13/02/24,Manchester Reds,30,10,8,18,4,8,58,31,27,58
2803414,13/02/24,Wolverhampton,30,7,6,13,9,8,40,26,14,48
2803414,13/02/24,Watford,30,10,4,14,7,9,43,40,3,49
2803414,13/02/24,London Guns,30,9,4,13,8,9,56,43,13,47
2803414,13/02/24,Everton,30,3,3,6,11,13,24,38,-14,29
2803414,13/02/24,Burnley,30,4,1,5,11,14,23,45,-22,26
2803414,13/02/24,Southampton,30,4,0,4,11,15,18,35,-17,23
2803414,13/02/24,Leicester,30,4,2,6,6,18,25,49,-24,24
2803414,13/02/24,Crystal Palace,30,5,3,8,7,15,32,51,-19,31
2803414,13/02/24,Newcastle,30,4,2,6,10,14,33,48,-15,28
2803437,13/02/24,Chelsea,30,7,6,13,8,9,36,28,8,47
2803437,13/02/24,Liverpool,30,10,9,19,7,4,59,22,37,64
2803437,13/02/24,Tottenham,30,7,4,11,11,8,39,33,6,44
2803437,13/02/24,Manchester Blue,30,8,8,16,7,7,59,36,23,55
2803437,13/02/24,Bournemouth,30,8,5,13,8,9,42,28,14,47
2803437,13/02/24,West Ham,30,6,5,11,5,14,34,40,-6,38
2803437,13/02/24,Manchester Reds,30,5,5,10,9,11,49,41,8,39
2803437,13/02/24,Wolverhampton,30,8,2,10,10,10,31,30,1,40
2803437,13/02/24,Watford,30,5,6,11,3,16,35,51,-16,36
2803437,13/02/24,London Guns,30,8,8,16,6,8,44,28,16,54
2803437,13/02/24,Everton,30,3,7,10,4,16,32,41,-9,34
2803437,13/02/24,Burnley,30,9,4,13,6,11,28,29,-1,45
2803437,13/02/24,Southampton,30,4,4,8,8,14,26,46,-20,32
2803437,13/02/24,Leicester,30,6,7,13,5,12,40,43,-3,44
2803437,13/02/24,Crystal Palace,30,6,1,7,2,21,29,59,-30,23
2803437,13/02/24,Newcastle,30,3,2,5,9,16,20,48,-28,24
2803464,13/02/24,Chelsea,30,8,8,16,3,11,56,42,14,51
2803464,13/02/24,Liverpool,30,8,7,15,7,8,51,35,16,52
2803464,13/02/24,Tottenham,30,6,7,13,7,10,41,39,2,46
2803464,13/02/24,Manchester Blue,30,10,9,19,4,7,56,29,27,61
2803464,13/02/24,Bournemouth,30,8,5,13,12,5,43,25,18,51
2803464,13/02/24,West Ham,30,3,1,4,7,19,24,55,-31,19
2803464,13/02/24,Manchester Reds,30,6,4,10,8,12,48,47,1,38
2803464,13/02/24,Wolverhampton,30,3,6,9,10,11,33,35,-2,37
2803464,13/02/24,Watford,30,3,5,8,9,13,30,42,-12,33
2803464,13/02/24,London Guns,30,9,9,18,6,6,62,36,26,60
2803464,13/02/24,Everton,30,5,8,13,5,12,38,40,-2,44
2803464,13/02/24,Burnley,30,7,5,12,9,9,26,28,-2,45
2803464,13/02/24,Southampton,30,3,6,9,7,14,32,45,-13,34
2803464,13/02/24,Leicester,30,5,5,10,9,11,38,39,-1,39
2803464,13/02/24,Crystal Palace,30,4,1,5,7,18,29,55,-26,22
2803464,13/02/24,Newcastle,30,3,2,5,12,13,29,44,-15,27
2803488,13/02/24,Chelsea,30,8,7,15,9,6,52,32,20,54
2803488,13/02/24,Liverpool,30,12,7,19,6,5,67,33,34,63
2803488,13/02/24,Tottenham,30,6,5,11,11,8,37,29,8,44
2803488,13/02/24,Manchester Blue,30,11,3,14,8,8,57,44,13,50
2803488,13/02/24,Bournemouth,30,11,7,18,6,6,43,25,18,60
2803488,13/02/24,West Ham,30,4,6,10,4,16,32,43,-11,34
2803488,13/02/24,Manchester Reds,30,4,7,11,9,10,38,38,0,42
2803488,13/02/24,Wolverhampton,30,7,3,10,9,11,31,33,-2,39
2803488,13/02/24,Watford,30,5,2,7,10,13,35,41,-6,31
2803488,13/02/24,London Guns,30,9,8,17,6,7,53,34,19,57
2803488,13/02/24,Everton,30,7,1,8,6,16,38,41,-3,30
2803488,13/02/24,Burnley,30,4,4,8,8,14,25,37,-12,32
2803488,13/02/24,Southampton,30,4,2,6,9,15,25,44,-19,27
2803488,13/02/24,Leicester,30,7,3,10,8,12,35,48,-13,38
2803488,13/02/24,Crystal Palace,30,5,4,9,5,16,27,49,-22,32
2803488,13/02/24,Newcastle,30,3,3,6,8,16,29,53,-24,26
2803515,13/02/24,Chelsea,30,7,7,14,8,8,51,35,16,50
2803515,13/02/24,Liverpool,30,7,7,14,7,9,44,37,7,49
2803515,13/02/24,Tottenham,30,7,7,14,6,10,52,46,6,48
2803515,13/02/24,Manchester Blue,30,11,4,15,6,9,50,35,15,51
2803515,13/02/24,Bournemouth,30,8,4,12,10,8,42,35,7,46
2803515,13/02/24,West Ham,30,4,5,9,14,7,42,40,2,41
2803515,13/02/24,Manchester Reds,30,6,10,16,9,5,45,30,15,57
2803515,13/02/24,Wolverhampton,30,4,5,9,10,11,26,29,-3,37
2803515,13/02/24,Watford,30,6,1,7,5,18,34,51,-17,26
2803515,13/02/24,London Guns,30,8,6,14,9,7,41,21,20,51
2803515,13/02/24,Everton,30,8,4,12,6,12,39,44,-5,42
2803515,13/02/24,Burnley,30,4,2,6,8,16,29,42,-13,26
2803515,13/02/24,Southampton,30,5,4,9,13,8,28,31,-3,40
2803515,13/02/24,Leicester,30,4,3,7,11,12,46,56,-10,32
2803515,13/02/24,Crystal Palace,30,4,5,9,10,11,29,41,-12,37
2803515,13/02/24,Newcastle,30,4,1,5,4,21,23,48,-25,19
2803543,13/02/24,Chelsea,30,9,6,15,11,4,42,22,20,56
2803543,13/02/24,Liverpool,30,8,7,15,10,5,44,24,20,55
2803543,13/02/24,Tottenham,30,7,6,13,11,6,45,34,11,50
2803543,13/02/24,Manchester Blue,30,11,9,20,7,3,62,25,37,67
2803543,13/02/24,Bournemouth,30,7,5,12,13,5,37,26,11,49
2803543,13/02/24,West Ham,30,4,3,7,6,17,31,46,-15,27
2803543,13/02/24,Manchester Reds,30,9,3,12,9,9,36,31,5,45
2803543,13/02/24,Wolverhampton,30,6,6,12,9,9,38,30,8,45
2803543,13/02/24,Watford,30,6,1,7,10,13,32,40,-8,31
2803543,13/02/24,London Guns,30,5,6,11,7,12,45,39,6,40
2803543,13/02/24,Everton,30,8,3,11,6,13,43,49,-6,39
2803543,13/02/24,Burnley,30,4,2,6,5,19,19,45,-26,23
2803543,13/02/24,Southampton,30,4,2,6,7,17,25,44,-19,25
2803543,13/02/24,Leicester,30,6,5,11,9,10,35,35,0,42
2803543,13/02/24,Crystal Palace,30,5,2,7,9,14,32,52,-20,30
2803543,13/02/24,Newcastle,30,6,1,7,7,16,27,51,-24,28
2803569,13/02/24,Chelsea,30,7,6,13,5,12,50,35,15,44
2803569,13/02/24,Liverpool,30,10,6,16,8,6,54,28,26,56
2803569,13/02/24,Tottenham,30,6,6,12,8,10,42,43,-1,44
2803569,13/02/24,Manchester Blue,30,11,6,17,5,8,63,37,26,56
2803569,13/02/24,Bournemouth,30,6,9,15,10,5,43,28,15,55
2803569,13/02/24,West Ham,30,4,3,7,7,16,29,58,-29,28
2803569,13/02/24,Manchester Reds,30,8,7,15,7,8,47,32,15,52
2803569,13/02/24,Wolverhampton,30,6,6,12,7,11,39,37,2,43
2803569,13/02/24,Watford,30,5,7,12,7,11,34,43,-9,43
2803569,13/02/24,London Guns,30,10,8,18,3,9,61,41,20,57
2803569,13/02/24,Everton,30,8,5,13,7,10,48,44,4,46
2803569,13/02/24,Burnley,30,7,3,10,4,16,28,40,-12,34
2803569,13/02/24,Southampton,30,5,3,8,7,15,30,42,-12,31
2803569,13/02/24,Leicester,30,6,3,9,7,14,41,51,-10,34
2803569,13/02/24,Crystal Palace,30,5,1,6,6,18,36,51,-15,24
2803569,13/02/24,Newcastle,30,3,3,6,4,20,16,51,-35,22
2803592,13/02/24,Chelsea,30,10,6,16,6,8,46,30,16,54
2803592,13/02/24,Liverpool,30,13,5,18,7,5,55,27,28,61
2803592,13/02/24,Tottenham,30,9,9,18,5,7,51,27,24,59
2803592,13/02/24,Manchester Blue,30,8,5,13,10,7,46,33,13,49
2803592,13/02/24,Bournemouth,30,10,4,14,9,7,49,24,25,51
2803592,13/02/24,West Ham,30,3,5,8,9,13,31,47,-16,33
2803592,13/02/24,Manchester Reds,30,7,6,13,9,8,39,29,10,48
2803592,13/02/24,Wolverhampton,30,4,4,8,10,12,25,42,-17,34
2803592,13/02/24,Watford,30,7,5,12,8,10,42,32,10,44
2803592,13/02/24,London Guns,30,10,7,17,6,7,49,31,18,57
2803592,13/02/24,Everton,30,5,4,9,5,16,36,45,-9,32
2803592,13/02/24,Burnley,30,6,3,9,8,13,24,36,-12,35
2803592,13/02/24,Southampton,30,4,2,6,6,18,17,40,-23,24
2803592,13/02/24,Leicester,30,8,2,10,5,15,38,53,-15,35
2803592,13/02/24,Crystal Palace,30,3,2,5,8,17,31,59,-28,23
2803592,13/02/24,Newcastle,30,4,1,5,7,18,30,54,-24,22
2803618,13/02/24,Chelsea,30,7,6,13,9,8,44,32,12,48
2803618,13/02/24,Liverpool,30,7,7,14,9,7,52,28,24,51
2803618,13/02/24,Tottenham,30,7,5,12,6,12,41,45,-4,42
2803618,13/02/24,Manchester Blue,30,8,10,18,6,6,58,35,23,60
2803618,13/02/24,Bournemouth,30,3,4,7,16,7,28,27,1,37
2803618,13/02/24,West Ham,30,5,4,9,5,16,38,57,-19,32
2803618,13/02/24,Manchester Reds,30,11,8,19,5,6,66,30,36,62
2803618,13/02/24,Wolverhampton,30,6,6,12,6,12,28,27,1,42
2803618,13/02/24,Watford,30,8,2,10,8,12,40,38,2,38
2803618,13/02/24,London Guns,30,5,7,12,8,10,47,37,10,44
2803618,13/02/24,Everton,30,11,7,18,6,6,53,38,15,60
2803618,13/02/24,Burnley,30,4,3,7,8,15,22,45,-23,29
2803618,13/02/24,Southampton,30,4,2,6,7,17,23,42,-19,25
2803618,13/02/24,Leicester,30,6,6,12,5,13,37,42,-5,41
2803618,13/02/24,Crystal Palace,30,4,3,7,5,18,29,54,-25,26
2803618,13/02/24,Newcastle,30,6,1,7,5,18,16,45,-29,26
2803643,13/02/24,Chelsea,30,13,9,22,4,4,59,21,38,70
2803643,13/02/24,Liverpool,30,6,7,13,8,9,48,31,17,47
2803643,13/02/24,Tottenham,30,7,5,12,3,15,35,43,-8,39
2803643,13/02/24,Manchester Blue,30,12,7,19,5,6,58,31,27,62
2803643,13/02/24,Bournemouth,30,9,7,16,5,9,44,28,16,53
2803643,13/02/24,West Ham,30,4,4,8,9,13,31,46,-15,33
2803643,13/02/24,Manchester Reds,30,3,3,6,11,13,35,47,-12,29
2803643,13/02/24,Wolverhampton,30,6,4,10,11,9,29,30,-1,41
2803643,13/02/24,Watford,30,7,3,10,6,14,31,40,-9,36
2803643,13/02/24,London Guns,30,11,5,16,4,10,51,39,12,52
2803643,13/02/24,Everton,30,5,4,9,9,12,35,45,-10,36
2803643,13/02/24,Burnley,30,4,4,8,12,10,23,24,-1,36
2803643,13/02/24,Southampton,30,3,5,8,8,14,31,43,-12,32
2803643,13/02/24,Leicester,30,8,4,12,9,9,43,37,6,45
2803643,13/02/24,Crystal Palace,30,4,3,7,6,17,25,49,-24,27
2803643,13/02/24,Newcastle,30,4,2,6,6,18,24,48,-24,24
2803667,13/02/24,Chelsea,30,9,10,19,4,7,53,30,23,61
2803667,13/02/24,Liverpool,30,10,9,19,7,4,52,26,26,64
2803667,13/02/24,Tottenham,30,4,7,11,9,10,40,38,2,42
2803667,13/02/24,Manchester Blue,30,11,9,20,5,5,62,31,31,65
2803667,13/02/24,Bournemouth,30,8,5,13,7,10,40,35,5,46
2803667,13/02/24,West Ham,30,3,5,8,7,15,34,49,-15,31
2803667,13/02/24,Manchester Reds,30,7,7,14,6,10,45,27,18,48
2803667,13/02/24,Wolverhampton,30,5,6,11,6,13,33,35,-2,39
2803667,13/02/24,Watford,30,6,3,9,7,14,36,45,-9,34
2803667,13/02/24,London Guns,30,8,11,19,5,6,51,27,24,62
2803667,13/02/24,Everton,30,7,2,9,5,16,29,40,-11,32
2803667,13/02/24,Burnley,30,3,5,8,8,14,20,34,-14,32
2803667,13/02/24,Southampton,30,6,1,7,8,15,20,34,-14,29
2803667,13/02/24,Leicester,30,8,1,9,5,16,38,50,-12,32
2803667,13/02/24,Crystal Palace,30,4,2,6,9,15,26,50,-24,27
2803667,13/02/24,Newcastle,30,4,1,5,8,17,21,49,-28,23
2803697,14/02/24,Chelsea,30,9,10,19,2,9,49,37,12,59
2803697,14/02/24,Liverpool,30,9,5,14,7,9,39,30,9,49
2803697,14/02/24,Tottenham,30,8,6,14,8,8,49,38,11,50
2803697,14/02/24,Manchester Blue,30,12,9,21,4,5,57,28,29,67
2803697,14/02/24,Bournemouth,30,11,5,16,8,6,39,26,13,56
2803697,14/02/24,West Ham,30,4,3,7,8,15,33,48,-15,29
2803697,14/02/24,Manchester Reds,30,10,5,15,8,7,50,32,18,53
2803697,14/02/24,Wolverhampton,30,5,4,9,10,11,32,33,-1,37
2803697,14/02/24,Watford,30,4,2,6,7,17,25,44,-19,25
2803697,14/02/24,London Guns,30,7,7,14,8,8,49,28,21,50
2803697,14/02/24,Everton,30,7,2,9,8,13,34,43,-9,35
2803697,14/02/24,Burnley,30,3,2,5,12,13,19,35,-16,27
2803697,14/02/24,Southampton,30,2,2,4,8,18,18,38,-20,20
2803697,14/02/24,Leicester,30,7,6,13,5,12,44,44,0,44
2803697,14/02/24,Crystal Palace,30,7,6,13,8,9,40,40,0,47
2803697,14/02/24,Newcastle,30,2,0,2,7,21,21,54,-33,13
2803726,14/02/24,Chelsea,30,8,5,13,8,9,45,40,5,47
2803726,14/02/24,Liverpool,30,8,6,14,5,11,49,36,13,47
2803726,14/02/24,Tottenham,30,9,5,14,5,11,47,40,7,47
2803726,14/02/24,Manchester Blue,30,10,7,17,9,4,65,32,33,60
2803726,14/02/24,Bournemouth,30,8,8,16,6,8,48,33,15,54
2803726,14/02/24,West Ham,30,3,2,5,11,14,33,45,-12,26
2803726,14/02/24,Manchester Reds,30,11,6,17,3,10,50,40,10,54
2803726,14/02/24,Wolverhampton,30,5,6,11,8,11,39,45,-6,41
2803726,14/02/24,Watford,30,6,5,11,10,9,31,35,-4,43
2803726,14/02/24,London Guns,30,12,7,19,6,5,54,28,26,63
2803726,14/02/24,Everton,30,8,4,12,9,9,43,34,9,45
2803726,14/02/24,Burnley,30,5,3,8,11,11,30,34,-4,35
2803726,14/02/24,Southampton,30,4,3,7,10,13,25,39,-14,31
2803726,14/02/24,Leicester,30,1,2,3,9,18,30,60,-30,18
2803726,14/02/24,Crystal Palace,30,3,2,5,8,17,27,50,-23,23
2803726,14/02/24,Newcastle,30,3,2,5,8,17,25,50,-25,23
2803751,14/02/24,Chelsea,30,8,8,16,5,9,55,32,23,53
2803751,14/02/24,Liverpool,30,5,7,12,8,10,42,32,10,44
2803751,14/02/24,Tottenham,30,7,5,12,7,11,39,40,-1,43
2803751,14/02/24,Manchester Blue,30,11,8,19,6,5,57,25,32,63
2803751,14/02/24,Bournemouth,30,6,6,12,8,10,33,32,1,44
2803751,14/02/24,West Ham,30,6,2,8,10,12,26,42,-16,34
2803751,14/02/24,Manchester Reds,30,10,6,16,7,7,52,30,22,55
2803751,14/02/24,Wolverhampton,30,5,5,10,9,11,31,31,0,39
2803751,14/02/24,Watford,30,7,8,15,3,12,41,33,8,48
2803751,14/02/24,London Guns,30,10,6,16,8,6,47,34,13,56
2803751,14/02/24,Everton,30,8,6,14,3,13,38,38,0,45
2803751,14/02/24,Burnley,30,5,2,7,10,13,19,32,-13,31
2803751,14/02/24,Southampton,30,2,3,5,7,18,21,42,-21,22
2803751,14/02/24,Leicester,30,2,4,6,6,18,26,51,-25,24
2803751,14/02/24,Crystal Palace,30,4,4,8,6,16,30,53,-23,30
2803751,14/02/24,Newcastle,30,3,4,7,11,12,25,35,-10,32
2803776,14/02/24,Chelsea,30,6,6,12,5,13,48,45,3,41
2803776,14/02/24,Liverpool,30,8,8,16,6,8,45,29,16,54
2803776,14/02/24,Tottenham,30,9,5,14,8,8,57,41,16,50
2803776,14/02/24,Manchester Blue,30,11,9,20,4,6,67,31,36,64
2803776,14/02/24,Bournemouth,30,9,7,16,2,12,43,36,7,50
2803776,14/02/24,West Ham,30,6,2,8,4,18,22,42,-20,28
2803776,14/02/24,Manchester Reds,30,8,8,16,6,8,39,28,11,54
2803776,14/02/24,Wolverhampton,30,4,5,9,5,16,25,38,-13,32
2803776,14/02/24,Watford,30,5,3,8,7,15,33,47,-14,31
2803776,14/02/24,London Guns,30,11,7,18,5,7,52,31,21,59
2803776,14/02/24,Everton,30,5,6,11,8,11,43,43,0,41
2803776,14/02/24,Burnley,30,6,1,7,4,19,21,42,-21,25
2803776,14/02/24,Southampton,30,4,4,8,7,15,35,52,-17,31
2803776,14/02/24,Leicester,30,9,6,15,5,10,47,45,2,50
2803776,14/02/24,Crystal Palace,30,4,5,9,6,15,34,44,-10,33
2803776,14/02/24,Newcastle,30,7,3,10,4,16,26,43,-17,34
2803801,14/02/24,Chelsea,30,11,9,20,4,6,50,24,26,64
2803801,14/02/24,Liverpool,30,9,12,21,3,6,61,35,26,66
2803801,14/02/24,Tottenham,30,6,7,13,9,8,40,28,12,48
2803801,14/02/24,Manchester Blue,30,8,5,13,11,6,43,31,12,50
2803801,14/02/24,Bournemouth,30,9,6,15,8,7,36,25,11,53
2803801,14/02/24,West Ham,30,5,1,6,10,14,29,40,-11,28
2803801,14/02/24,Manchester Reds,30,8,6,14,5,11,41,37,4,47
2803801,14/02/24,Wolverhampton,30,7,4,11,11,8,34,31,3,44
2803801,14/02/24,Watford,30,6,4,10,9,11,36,35,1,39
2803801,14/02/24,London Guns,30,9,7,16,4,10,56,42,14,52
2803801,14/02/24,Everton,30,4,6,10,10,10,33,42,-9,40
2803801,14/02/24,Burnley,30,4,2,6,7,17,22,39,-17,25
2803801,14/02/24,Southampton,30,4,1,5,11,14,13,36,-23,26
2803801,14/02/24,Leicester,30,4,2,6,9,15,35,42,-7,27
2803801,14/02/24,Crystal Palace,30,4,1,5,5,20,32,57,-25,20
2803801,14/02/24,Newcastle,30,4,3,7,8,15,23,40,-17,29
2803826,14/02/24,Chelsea,30,10,7,17,4,9,52,37,15,55
2803826,14/02/24,Liverpool,30,10,10,20,5,5,49,24,25,65
2803826,14/02/24,Tottenham,30,8,4,12,10,8,45,40,5,46
2803826,14/02/24,Manchester Blue,30,9,8,17,6,7,52,35,17,57
2803826,14/02/24,Bournemouth,30,8,6,14,6,10,32,23,9,48
2803826,14/02/24,West Ham,30,6,3,9,6,15,34,40,-6,33
2803826,14/02/24,Manchester Reds,30,8,9,17,6,7,49,26,23,57
2803826,14/02/24,Wolverhampton,30,9,5,14,5,11,34,23,11,47
2803826,14/02/24,Watford,30,6,2,8,6,16,29,40,-11,30
2803826,14/02/24,London Guns,30,11,5,16,5,9,58,43,15,53
2803826,14/02/24,Everton,30,6,4,10,6,14,35,42,-7,36
2803826,14/02/24,Burnley,30,6,6,12,4,14,27,34,-7,40
2803826,14/02/24,Southampton,30,4,2,6,6,18,23,55,-32,24
2803826,14/02/24,Leicester,30,8,5,13,1,16,39,48,-9,40
2803826,14/02/24,Crystal Palace,30,3,1,4,9,17,21,45,-24,21
2803826,14/02/24,Newcastle,30,3,3,6,5,19,24,48,-24,23
2803849,14/02/24,Chelsea,30,7,6,13,9,8,46,34,12,48
2803849,14/02/24,Liverpool,30,8,8,16,5,9,54,33,21,53
2803849,14/02/24,Tottenham,30,11,5,16,5,9,58,37,21,53
2803849,14/02/24,Manchester Blue,30,11,7,18,3,9,53,36,17,57
2803849,14/02/24,Bournemouth,30,8,4,12,9,9,40,31,9,45
2803849,14/02/24,West Ham,30,5,1,6,10,14,35,45,-10,28
2803849,14/02/24,Manchester Reds,30,10,5,15,7,8,48,36,12,52
2803849,14/02/24,Wolverhampton,30,6,6,12,6,12,36,30,6,42
2803849,14/02/24,Watford,30,6,4,10,6,14,34,47,-13,36
2803849,14/02/24,London Guns,30,10,7,17,5,8,57,36,21,56
2803849,14/02/24,Everton,30,4,6,10,10,10,41,41,0,40
2803849,14/02/24,Burnley,30,7,4,11,7,12,29,38,-9,40
2803849,14/02/24,Southampton,30,6,3,9,7,14,23,41,-18,34
2803849,14/02/24,Leicester,30,8,1,9,7,14,46,63,-17,34
2803849,14/02/24,Crystal Palace,30,4,2,6,7,17,35,54,-19,25
2803849,14/02/24,Newcastle,30,4,2,6,5,19,18,51,-33,23
2803878,14/02/24,Chelsea,30,8,7,15,8,7,43,26,17,53
2803878,14/02/24,Liverpool,30,12,9,21,5,4,54,24,30,68
2803878,14/02/24,Tottenham,30,9,6,15,8,7,38,30,8,53
2803878,14/02/24,Manchester Blue,30,10,7,17,4,9,57,29,28,55
2803878,14/02/24,Bournemouth,30,6,4,10,11,9,45,42,3,41
2803878,14/02/24,West Ham,30,3,5,8,9,13,26,43,-17,33
2803878,14/02/24,Manchester Reds,30,10,9,19,5,6,61,27,34,62
2803878,14/02/24,Wolverhampton,30,8,5,13,4,13,34,31,3,43
2803878,14/02/24,Watford,30,5,1,6,9,15,37,53,-16,27
2803878,14/02/24,London Guns,30,11,7,18,5,7,51,28,23,59
2803878,14/02/24,Everton,30,5,3,8,8,14,28,42,-14,32
2803878,14/02/24,Burnley,30,5,2,7,10,13,26,38,-12,31
2803878,14/02/24,Southampton,30,3,3,6,5,19,30,60,-30,23
2803878,14/02/24,Leicester,30,9,2,11,6,13,38,45,-7,39
2803878,14/02/24,Crystal Palace,30,6,1,7,7,16,23,42,-19,28
2803878,14/02/24,Newcastle,30,3,1,4,6,20,23,54,-31,18
2803902,14/02/24,Chelsea,30,7,7,14,8,8,49,37,12,50
2803902,14/02/24,Liverpool,30,11,8,19,5,6,57,31,26,62
2803902,14/02/24,Tottenham,30,7,3,10,11,9,49,43,6,41
2803902,14/02/24,Manchester Blue,30,13,7,20,3,7,68,36,32,63
2803902,14/02/24,Bournemouth,30,8,8,16,7,7,50,35,15,55
2803902,14/02/24,West Ham,30,4,3,7,4,19,30,58,-28,25
2803902,14/02/24,Manchester Reds,30,9,8,17,9,4,50,25,25,60
2803902,14/02/24,Wolverhampton,30,6,4,10,10,10,39,37,2,40
2803902,14/02/24,Watford,30,4,5,9,7,14,33,43,-10,34
2803902,14/02/24,London Guns,30,10,8,18,5,7,50,25,25,59
2803902,14/02/24,Everton,30,6,5,11,8,11,42,35,7,41
2803902,14/02/24,Burnley,30,7,4,11,5,14,32,40,-8,38
2803902,14/02/24,Southampton,30,5,1,6,4,20,24,55,-31,22
2803902,14/02/24,Leicester,30,3,5,8,7,15,35,52,-17,31
2803902,14/02/24,Crystal Palace,30,2,4,6,9,15,23,41,-18,27
2803902,14/02/24,Newcastle,30,4,2,6,2,22,19,57,-38,20
2803930,14/02/24,Chelsea,30,9,9,18,5,7,54,27,27,59
2803930,14/02/24,Liverpool,30,11,8,19,5,6,46,25,21,62
2803930,14/02/24,Tottenham,30,8,6,14,8,8,44,34,10,50
2803930,14/02/24,Manchester Blue,30,10,10,20,6,4,63,31,32,66
2803930,14/02/24,Bournemouth,30,6,3,9,13,8,37,32,5,40
2803930,14/02/24,West Ham,30,4,3,7,5,18,32,52,-20,26
2803930,14/02/24,Manchester Reds,30,7,7,14,9,7,45,33,12,51
2803930,14/02/24,Wolverhampton,30,7,7,14,3,13,31,35,-4,45
2803930,14/02/24,Watford,30,6,6,12,10,8,52,37,15,46
2803930,14/02/24,London Guns,30,8,8,16,2,12,57,46,11,50
2803930,14/02/24,Everton,30,6,4,10,6,14,35,39,-4,36
2803930,14/02/24,Burnley,30,3,2,5,12,13,23,45,-22,27
2803930,14/02/24,Southampton,30,3,2,5,6,19,22,55,-33,21
2803930,14/02/24,Leicester,30,5,5,10,8,12,46,44,2,38
2803930,14/02/24,Crystal Palace,30,5,2,7,2,21,31,58,-27,23
2803930,14/02/24,Newcastle,30,4,2,6,8,16,30,55,-25,26
2803954,14/02/24,Chelsea,30,9,6,15,10,5,43,28,15,55
2803954,14/02/24,Liverpool,30,11,5,16,5,9,49,31,18,53
2803954,14/02/24,Tottenham,30,5,6,11,10,9,39,34,5,43
2803954,14/02/24,Manchester Blue,30,10,9,19,4,7,66,36,30,61
2803954,14/02/24,Bournemouth,30,12,4,16,8,6,41,25,16,56
2803954,14/02/24,West Ham,30,5,1,6,11,13,28,41,-13,29
2803954,14/02/24,Manchester Reds,30,10,5,15,6,9,40,28,12,51
2803954,14/02/24,Wolverhampton,30,10,5,15,4,11,29,32,-3,49
2803954,14/02/24,Watford,30,7,3,10,7,13,25,39,-14,37
2803954,14/02/24,London Guns,30,11,8,19,7,4,53,17,36,64
2803954,14/02/24,Everton,30,5,4,9,9,12,41,45,-4,36
2803954,14/02/24,Burnley,30,4,1,5,7,18,27,49,-22,22
2803954,14/02/24,Southampton,30,2,2,4,12,14,26,43,-17,24
2803954,14/02/24,Leicester,30,4,3,7,9,14,41,50,-9,30
2803954,14/02/24,Crystal Palace,30,7,3,10,5,15,29,47,-18,35
2803954,14/02/24,Newcastle,30,2,2,4,4,22,21,53,-32,16
2803981,14/02/24,Chelsea,30,14,9,23,2,5,64,31,33,71
2803981,14/02/24,Liverpool,30,11,5,16,9,5,63,35,28,57
2803981,14/02/24,Tottenham,30,7,8,15,5,10,48,40,8,50
2803981,14/02/24,Manchester Blue,30,11,6,17,4,9,64,39,25,55
2803981,14/02/24,Bournemouth,30,4,4,8,12,10,33,35,-2,36
2803981,14/02/24,West Ham,30,4,2,6,10,14,23,47,-24,28
2803981,14/02/24,Manchester Reds,30,10,9,19,5,6,57,29,28,62
2803981,14/02/24,Wolverhampton,30,4,1,5,10,15,29,43,-14,25
2803981,14/02/24,Watford,30,8,1,9,7,14,35,49,-14,34
2803981,14/02/24,London Guns,30,8,7,15,8,7,51,38,13,53
2803981,14/02/24,Everton,30,9,3,12,7,11,39,46,-7,43
2803981,14/02/24,Burnley,30,6,4,10,9,11,25,24,1,39
2803981,14/02/24,Southampton,30,3,0,3,9,18,22,52,-30,18
2803981,14/02/24,Leicester,30,7,4,11,8,11,48,43,5,41
2803981,14/02/24,Crystal Palace,30,1,2,3,7,20,26,59,-33,16
2803981,14/02/24,Newcastle,30,6,3,9,6,15,37,54,-17,33
2804004,14/02/24,Chelsea,30,9,4,13,8,9,33,25,8,47
2804004,14/02/24,Liverpool,30,11,11,22,4,4,61,21,40,70
2804004,14/02/24,Tottenham,30,10,9,19,7,4,49,31,18,64
2804004,14/02/24,Manchester Blue,30,9,7,16,9,5,48,28,20,57
2804004,14/02/24,Bournemouth,30,5,5,10,7,13,25,27,-2,37
2804004,14/02/24,West Ham,30,3,3,6,10,14,25,39,-14,28
2804004,14/02/24,Manchester Reds,30,7,5,12,5,13,41,46,-5,41
2804004,14/02/24,Wolverhampton,30,6,4,10,12,8,41,36,5,42
2804004,14/02/24,Watford,30,8,3,11,7,12,31,34,-3,40
2804004,14/02/24,London Guns,30,8,1,9,8,13,38,44,-6,35
2804004,14/02/24,Everton,30,5,5,10,8,12,38,43,-5,38
2804004,14/02/24,Burnley,30,8,4,12,6,12,32,39,-7,42
2804004,14/02/24,Southampton,30,5,2,7,6,17,25,37,-12,27
2804004,14/02/24,Leicester,30,3,6,9,5,16,42,48,-6,32
2804004,14/02/24,Crystal Palace,30,7,3,10,9,11,32,36,-4,39
2804004,14/02/24,Newcastle,30,4,2,6,5,19,26,53,-27,23
2804033,15/02/24,Chelsea,30,8,8,16,10,4,48,28,20,58
2804033,15/02/24,Liverpool,30,7,4,11,11,8,43,34,9,44
2804033,15/02/24,Tottenham,30,7,7,14,7,9,39,31,8,49
2804033,15/02/24,Manchester Blue,30,10,8,18,9,3,58,24,34,63
2804033,15/02/24,Bournemouth,30,9,6,15,7,8,40,25,15,52
2804033,15/02/24,West Ham,30,4,5,9,8,13,43,49,-6,35
2804033,15/02/24,Manchester Reds,30,8,5,13,9,8,40,30,10,48
2804033,15/02/24,Wolverhampton,30,6,3,9,6,15,27,39,-12,33
2804033,15/02/24,Watford,30,6,3,9,9,12,27,39,-12,36
2804033,15/02/24,London Guns,30,8,6,14,11,5,51,31,20,53
2804033,15/02/24,Everton,30,8,4,12,6,12,40,38,2,42
2804033,15/02/24,Burnley,30,6,3,9,7,14,22,31,-9,34
2804033,15/02/24,Southampton,30,2,1,3,11,16,13,36,-23,20
2804033,15/02/24,Leicester,30,7,3,10,10,10,36,44,-8,40
2804033,15/02/24,Crystal Palace,30,4,2,6,8,16,34,54,-20,26
2804033,15/02/24,Newcastle,30,2,2,4,7,19,14,42,-28,19
2804058,15/02/24,Chelsea,30,10,10,20,5,5,65,24,41,65
2804058,15/02/24,Liverpool,30,11,10,21,6,3,54,17,37,69
2804058,15/02/24,Tottenham,30,11,8,19,5,6,56,35,21,62
2804058,15/02/24,Manchester Blue,30,6,6,12,7,11,49,36,13,43
2804058,15/02/24,Bournemouth,30,9,6,15,6,9,45,30,15,51
2804058,15/02/24,West Ham,30,4,2,6,5,19,27,52,-25,23
2804058,15/02/24,Manchester Reds,30,8,9,17,8,5,53,33,20,59
2804058,15/02/24,Wolverhampton,30,8,4,12,6,12,41,41,0,42
2804058,15/02/24,Watford,30,3,3,6,10,14,38,49,-11,28
2804058,15/02/24,London Guns,30,8,8,16,5,9,53,34,19,53
2804058,15/02/24,Everton,30,9,3,12,4,14,44,47,-3,40
2804058,15/02/24,Burnley,30,3,4,7,11,12,24,41,-17,32
2804058,15/02/24,Southampton,30,3,0,3,8,19,19,51,-32,17
2804058,15/02/24,Leicester,30,7,3,10,7,13,40,48,-8,37
2804058,15/02/24,Crystal Palace,30,1,1,2,5,23,24,74,-50,11
2804058,15/02/24,Newcastle,30,4,5,9,8,13,34,54,-20,35
2804083,15/02/24,Chelsea,30,10,8,18,10,2,57,21,36,64
2804083,15/02/24,Liverpool,30,9,7,16,6,8,50,32,18,54
2804083,15/02/24,Tottenham,30,10,5,15,6,9,42,37,5,51
2804083,15/02/24,Manchester Blue,30,8,10,18,9,3,58,28,30,63
2804083,15/02/24,Bournemouth,30,8,5,13,9,8,43,29,14,48
2804083,15/02/24,West Ham,30,6,3,9,7,14,37,42,-5,34
2804083,15/02/24,Manchester Reds,30,11,3,14,3,13,42,47,-5,45
2804083,15/02/24,Wolverhampton,30,7,3,10,4,16,35,45,-10,34
2804083,15/02/24,Watford,30,9,3,12,5,13,29,33,-4,41
2804083,15/02/24,London Guns,30,10,10,20,4,6,69,31,38,64
2804083,15/02/24,Everton,30,8,3,11,6,13,41,50,-9,39
2804083,15/02/24,Burnley,30,3,2,5,5,20,17,43,-26,20
2804083,15/02/24,Southampton,30,4,3,7,7,16,25,48,-23,28
2804083,15/02/24,Leicester,30,10,2,12,4,14,42,53,-11,40
2804083,15/02/24,Crystal Palace,30,3,4,7,5,18,31,55,-24,26
2804083,15/02/24,Newcastle,30,4,0,4,8,18,32,56,-24,20
2804106,15/02/24,Chelsea,30,7,6,13,6,11,42,36,6,45
2804106,15/02/24,Liverpool,30,8,8,16,8,6,52,28,24,56
2804106,15/02/24,Tottenham,30,9,6,15,9,6,53,39,14,54
2804106,15/02/24,Manchester Blue,30,9,10,19,7,4,71,28,43,64
2804106,15/02/24,Bournemouth,30,7,8,15,4,11,36,30,6,49
2804106,15/02/24,West Ham,30,3,2,5,12,13,31,46,-15,27
2804106,15/02/24,Manchester Reds,30,8,8,16,4,10,46,33,13,52
2804106,15/02/24,Wolverhampton,30,5,6,11,6,13,32,38,-6,39
2804106,15/02/24,Watford,30,6,4,10,5,15,38,43,-5,35
2804106,15/02/24,London Guns,30,8,8,16,5,9,49,31,18,53
2804106,15/02/24,Everton,30,9,6,15,5,10,41,44,-3,50
2804106,15/02/24,Burnley,30,5,4,9,7,14,27,39,-12,34
2804106,15/02/24,Southampton,30,0,1,1,8,21,14,58,-44,11
2804106,15/02/24,Leicester,30,9,9,18,4,8,58,35,23,58
2804106,15/02/24,Crystal Palace,30,4,3,7,5,18,29,55,-26,26
2804106,15/02/24,Newcastle,30,2,0,2,9,19,17,53,-36,15
2804135,15/02/24,Chelsea,30,10,8,18,9,3,53,25,28,63
2804135,15/02/24,Liverpool,30,8,6,14,8,8,47,32,15,50
2804135,15/02/24,Tottenham,30,8,7,15,5,10,46,36,10,50
2804135,15/02/24,Manchester Blue,30,10,5,15,10,5,61,40,21,55
2804135,15/02/24,Bournemouth,30,7,5,12,11,7,38,25,13,47
2804135,15/02/24,West Ham,30,6,2,8,9,13,29,33,-4,33
2804135,15/02/24,Manchester Reds,30,6,5,11,4,15,35,41,-6,37
2804135,15/02/24,Wolverhampton,30,7,2,9,11,10,26,27,-1,38
2804135,15/02/24,Watford,30,6,2,8,8,14,29,43,-14,32
2804135,15/02/24,London Guns,30,8,9,17,5,8,51,34,17,56
2804135,15/02/24,Everton,30,4,3,7,9,14,35,45,-10,30
2804135,15/02/24,Burnley,30,5,5,10,9,11,26,32,-6,39
2804135,15/02/24,Southampton,30,5,2,7,4,19,33,62,-29,25
2804135,15/02/24,Leicester,30,7,5,12,4,14,42,39,3,40
2804135,15/02/24,Crystal Palace,30,3,5,8,10,12,32,45,-13,34
2804135,15/02/24,Newcastle,30,5,2,7,8,15,22,46,-24,29
2804159,15/02/24,Chelsea,30,11,7,18,10,2,57,26,31,64
2804159,15/02/24,Liverpool,30,10,4,14,8,8,51,32,19,50
2804159,15/02/24,Tottenham,30,6,3,9,6,15,38,47,-9,33
2804159,15/02/24,Manchester Blue,30,12,10,22,6,2,62,20,42,72
2804159,15/02/24,Bournemouth,30,7,7,14,7,9,40,33,7,49
2804159,15/02/24,West Ham,30,6,3,9,4,17,32,51,-19,31
2804159,15/02/24,Manchester Reds,30,7,8,15,8,7,41,29,12,53
2804159,15/02/24,Wolverhampton,30,6,3,9,8,13,28,27,1,35
2804159,15/02/24,Watford,30,6,4,10,6,14,40,49,-9,36
2804159,15/02/24,London Guns,30,9,6,15,4,11,43,40,3,49
2804159,15/02/24,Everton,30,4,8,12,8,10,33,37,-4,44
2804159,15/02/24,Burnley,30,2,1,3,11,16,17,42,-25,20
2804159,15/02/24,Southampton,30,5,5,10,6,14,24,31,-7,36
2804159,15/02/24,Leicester,30,4,6,10,6,14,49,55,-6,36
2804159,15/02/24,Crystal Palace,30,4,3,7,10,13,34,43,-9,31
2804159,15/02/24,Newcastle,30,1,3,4,10,16,20,47,-27,22
2804184,15/02/24,Chelsea,30,7,9,16,4,10,41,23,18,52
2804184,15/02/24,Liverpool,30,7,6,13,8,9,43,36,7,47
2804184,15/02/24,Tottenham,30,7,4,11,7,12,46,42,4,40
2804184,15/02/24,Manchester Blue,30,11,6,17,6,7,63,36,27,57
2804184,15/02/24,Bournemouth,30,6,6,12,5,13,38,33,5,41
2804184,15/02/24,West Ham,30,5,1,6,10,14,28,43,-15,28
2804184,15/02/24,Manchester Reds,30,9,3,12,8,10,39,38,1,44
2804184,15/02/24,Wolverhampton,30,3,4,7,8,15,27,46,-19,29
2804184,15/02/24,Watford,30,8,5,13,9,8,40,31,9,48
2804184,15/02/24,London Guns,30,8,9,17,8,5,40,21,19,59
2804184,15/02/24,Everton,30,6,5,11,11,8,41,36,5,44
2804184,15/02/24,Burnley,30,4,3,7,7,16,21,39,-18,28
2804184,15/02/24,Southampton,30,5,2,7,6,17,26,36,-10,27
2804184,15/02/24,Leicester,30,8,7,15,4,11,40,47,-7,49
2804184,15/02/24,Crystal Palace,30,8,6,14,5,11,32,36,-4,47
2804184,15/02/24,Newcastle,30,3,2,5,8,17,25,47,-22,23
2804212,15/02/24,Chelsea,30,9,8,17,8,5,51,29,22,59
2804212,15/02/24,Liverpool,30,6,4,10,13,7,47,34,13,43
2804212,15/02/24,Tottenham,30,10,4,14,8,8,54,34,20,50
2804212,15/02/24,Manchester Blue,30,10,6,16,7,7,54,33,21,55
2804212,15/02/24,Bournemouth,30,10,9,19,2,9,42,27,15,59
2804212,15/02/24,West Ham,30,7,2,9,5,16,37,45,-8,32
2804212,15/02/24,Manchester Reds,30,5,3,8,9,13,33,41,-8,33
2804212,15/02/24,Wolverhampton,30,4,3,7,10,13,30,36,-6,31
2804212,15/02/24,Watford,30,7,4,11,8,11,32,37,-5,41
2804212,15/02/24,London Guns,30,7,8,15,9,6,51,39,12,54
2804212,15/02/24,Everton,30,5,4,9,9,12,36,46,-10,36
2804212,15/02/24,Burnley,30,8,5,13,5,12,30,34,-4,44
2804212,15/02/24,Southampton,30,5,3,8,7,15,29,41,-12,31
2804212,15/02/24,Leicester,30,5,3,8,12,10,39,47,-8,36
2804212,15/02/24,Crystal Palace,30,5,4,9,5,16,30,48,-18,32
2804212,15/02/24,Newcastle,30,4,0,4,9,17,22,46,-24,21
2804239,15/02/24,Chelsea,30,9,6,15,4,11,41,28,13,49
2804239,15/02/24,Liverpool,30,6,6,12,11,7,45,39,6,47
2804239,15/02/24,Tottenham,30,7,5,12,9,9,39,34,5,45
2804239,15/02/24,Manchester Blue,30,10,5,15,9,6,60,34,26,54
2804239,15/02/24,Bournemouth,30,9,6,15,8,7,45,28,17,53
2804239,15/02/24,West Ham,30,7,2,9,6,15,35,50,-15,33
2804239,15/02/24,Manchester Reds,30,12,7,19,6,5,55,26,29,63
2804239,15/02/24,Wolverhampton,30,2,2,4,12,14,28,38,-10,24
2804239,15/02/24,Watford,30,8,3,11,3,16,37,45,-8,36
2804239,15/02/24,London Guns,30,10,8,18,8,4,57,28,29,62
2804239,15/02/24,Everton,30,9,2,11,11,8,39,40,-1,44
2804239,15/02/24,Burnley,30,4,8,12,7,11,36,35,1,43
2804239,15/02/24,Southampton,30,2,2,4,10,16,16,41,-25,22
2804239,15/02/24,Leicester,30,8,1,9,7,14,36,53,-17,34
2804239,15/02/24,Crystal Palace,30,2,2,4,9,17,25,51,-26,21
2804239,15/02/24,Newcastle,30,5,2,7,6,17,24,48,-24,27
2804261,15/02/24,Chelsea,30,8,8,16,11,3,57,30,27,59
2804261,15/02/24,Liverpool,30,7,9,16,8,6,52,30,22,56
2804261,15/02/24,Tottenham,30,9,6,15,9,6,55,32,23,54
2804261,15/02/24,Manchester Blue,30,9,10,19,6,5,64,32,32,63
2804261,15/02/24,Bournemouth,30,11,5,16,6,8,49,29,20,54
2804261,15/02/24,West Ham,30,6,2,8,9,13,34,51,-17,33
2804261,15/02/24,Manchester Reds,30,8,7,15,8,7,54,37,17,53
2804261,15/02/24,Wolverhampton,30,4,5,9,10,11,28,32,-4,37
2804261,15/02/24,Watford,30,5,1,6,9,15,25,41,-16,27
2804261,15/02/24,London Guns,30,9,4,13,11,6,52,31,21,50
2804261,15/02/24,Everton,30,3,3,6,11,13,35,51,-16,29
2804261,15/02/24,Burnley,30,5,6,11,4,15,30,39,-9,37
2804261,15/02/24,Southampton,30,5,1,6,10,14,27,51,-24,28
2804261,15/02/24,Leicester,30,4,3,7,6,17,30,52,-22,27
2804261,15/02/24,Crystal Palace,30,4,5,9,8,13,40,55,-15,35
2804261,15/02/24,Newcastle,30,1,1,2,6,22,25,64,-39,12
2804288,15/02/24,Chelsea,30,9,6,15,9,6,50,25,25,54
2804288,15/02/24,Liverpool,30,12,4,16,7,7,46,32,14,55
2804288,15/02/24,Tottenham,30,7,7,14,6,10,49,33,16,48
2804288,15/02/24,Manchester Blue,30,13,8,21,7,2,55,19,36,70
2804288,15/02/24,Bournemouth,30,8,3,11,5,14,35,33,2,38
2804288,15/02/24,West Ham,30,7,1,8,6,16,23,42,-19,30
2804288,15/02/24,Manchester Reds,30,9,5,14,7,9,41,32,9,49
2804288,15/02/24,Wolverhampton,30,1,3,4,11,15,16,37,-21,23
2804288,15/02/24,Watford,30,5,2,7,8,15,22,46,-24,29
2804288,15/02/24,London Guns,30,8,7,15,5,10,47,43,4,50
2804288,15/02/24,Everton,30,8,5,13,8,9,42,40,2,47
2804288,15/02/24,Burnley,30,5,5,10,8,12,29,29,0,38
2804288,15/02/24,Southampton,30,6,1,7,10,13,29,36,-7,31
2804288,15/02/24,Leicester,30,9,3,12,7,11,38,43,-5,43
2804288,15/02/24,Crystal Palace,30,4,2,6,9,15,26,39,-13,27
2804288,15/02/24,Newcastle,30,5,2,7,7,16,25,44,-19,28
2804313,15/02/24,Chelsea,30,10,5,15,8,7,40,26,14,53
2804313,15/02/24,Liverpool,30,10,11,21,2,7,60,25,35,65
2804313,15/02/24,Tottenham,30,6,6,12,7,11,42,36,6,43
2804313,15/02/24,Manchester Blue,30,13,7,20,1,9,66,30,36,61
2804313,15/02/24,Bournemouth,30,6,8,14,6,10,35,32,3,48
2804313,15/02/24,West Ham,30,2,3,5,4,21,29,58,-29,19
2804313,15/02/24,Manchester Reds,30,10,5,15,6,9,47,36,11,51
2804313,15/02/24,Wolverhampton,30,4,8,12,9,9,39,36,3,45
2804313,15/02/24,Watford,30,6,1,7,11,12,33,46,-13,32
2804313,15/02/24,London Guns,30,8,11,19,5,6,63,40,23,62
2804313,15/02/24,Everton,30,9,2,11,6,13,51,54,-3,39
2804313,15/02/24,Burnley,30,3,4,7,7,16,20,38,-18,28
2804313,15/02/24,Southampton,30,3,3,6,10,14,26,44,-18,28
2804313,15/02/24,Leicester,30,3,5,8,7,15,34,43,-9,31
2804313,15/02/24,Crystal Palace,30,5,5,10,6,14,32,42,-10,36
2804313,15/02/24,Newcastle,30,3,3,6,9,15,28,59,-31,27
2804338,15/02/24,Chelsea,30,10,8,18,5,7,51,22,29,59
2804338,15/02/24,Liverpool,30,9,7,16,10,4,46,28,18,58
2804338,15/02/24,Tottenham,30,8,6,14,9,7,54,32,22,51
2804338,15/02/24,Manchester Blue,30,9,5,14,7,9,51,37,14,49
2804338,15/02/24,Bournemouth,30,6,3,9,10,11,43,39,4,37
2804338,15/02/24,West Ham,30,7,1,8,2,20,23,51,-28,26
2804338,15/02/24,Manchester Reds,30,9,7,16,8,6,55,36,19,56
2804338,15/02/24,Wolverhampton,30,7,1,8,9,13,32,42,-10,33
2804338,15/02/24,Watford,30,8,4,12,6,12,35,45,-10,42
2804338,15/02/24,London Guns,30,10,7,17,7,6,45,25,20,58
2804338,15/02/24,Everton,30,7,4,11,7,12,50,51,-1,40
2804338,15/02/24,Burnley,30,3,1,4,6,20,17,43,-26,18
2804338,15/02/24,Southampton,30,4,4,8,11,11,27,32,-5,35
2804338,15/02/24,Leicester,30,5,4,9,9,12,35,43,-8,36
2804338,15/02/24,Crystal Palace,30,6,3,9,7,14,22,38,-16,34
2804338,15/02/24,Newcastle,30,4,3,7,7,16,34,56,-22,28
2804366,16/02/24,Chelsea,30,8,8,16,8,6,54,23,31,56
2804366,16/02/24,Liverpool,30,13,6,19,5,6,53,22,31,62
2804366,16/02/24,Tottenham,30,6,6,12,7,11,36,39,-3,43
2804366,16/02/24,Manchester Blue,30,9,8,17,7,6,52,31,21,58
2804366,16/02/24,Bournemouth,30,10,10,20,4,6,61,29,32,64
2804366,16/02/24,West Ham,30,6,3,9,3,18,36,54,-18,30
2804366,16/02/24,Manchester Reds,30,7,7,14,6,10,50,33,17,48
2804366,16/02/24,Wolverhampton,30,5,6,11,8,11,34,42,-8,41
2804366,16/02/24,Watford,30,9,1,10,7,13,37,38,-1,37
2804366,16/02/24,London Guns,30,5,7,12,8,10,46,35,11,44
2804366,16/02/24,Everton,30,7,4,11,6,13,35,45,-10,39
2804366,16/02/24,Burnley,30,5,4,9,9,12,25,40,-15,36
2804366,16/02/24,Southampton,30,4,2,6,7,17,20,49,-29,25
2804366,16/02/24,Leicester,30,7,5,12,5,13,41,43,-2,41
2804366,16/02/24,Crystal Palace,30,3,2,5,4,21,23,57,-34,19
2804366,16/02/24,Newcastle,30,4,4,8,4,18,23,46,-23,28
2804392,16/02/24,Chelsea,30,6,9,15,10,5,47,27,20,55
2804392,16/02/24,Liverpool,30,9,12,21,3,6,60,26,34,66
2804392,16/02/24,Tottenham,30,4,6,10,10,10,41,41,0,40
2804392,16/02/24,Manchester Blue,30,9,5,14,8,8,54,36,18,50
2804392,16/02/24,Bournemouth,30,8,6,14,7,9,42,28,14,49
2804392,16/02/24,West Ham,30,4,3,7,10,13,33,47,-14,31
2804392,16/02/24,Manchester Reds,30,9,6,15,5,10,49,40,9,50
2804392,16/02/24,Wolverhampton,30,8,5,13,4,13,26,36,-10,43
2804392,16/02/24,Watford,30,6,4,10,8,12,28,31,-3,38
2804392,16/02/24,London Guns,30,9,10,19,5,6,59,22,37,62
2804392,16/02/24,Everton,30,6,6,12,8,10,38,46,-8,44
2804392,16/02/24,Burnley,30,5,2,7,6,17,21,46,-25,27
2804392,16/02/24,Southampton,30,4,2,6,7,17,24,45,-21,25
2804392,16/02/24,Leicester,30,7,4,11,4,15,41,53,-12,37
2804392,16/02/24,Crystal Palace,30,2,3,5,8,17,28,49,-21,23
2804392,16/02/24,Newcastle,30,3,3,6,7,17,25,43,-18,25
2804416,16/02/24,Chelsea,30,7,9,16,11,3,53,32,21,59
2804416,16/02/24,Liverpool,30,11,8,19,8,3,60,28,32,65
2804416,16/02/24,Tottenham,30,11,8,19,4,7,49,30,19,61
2804416,16/02/24,Manchester Blue,30,6,5,11,7,12,52,46,6,40
2804416,16/02/24,Bournemouth,30,9,5,14,7,9,43,30,13,49
2804416,16/02/24,West Ham,30,4,3,7,12,11,29,37,-8,33
2804416,16/02/24,Manchester Reds,30,5,6,11,8,11,39,40,-1,41
2804416,16/02/24,Wolverhampton,30,7,6,13,7,10,38,33,5,46
2804416,16/02/24,Watford,30,6,2,8,10,12,32,44,-12,34
2804416,16/02/24,London Guns,30,8,7,15,7,8,55,31,24,52
2804416,16/02/24,Everton,30,7,4,11,5,14,34,44,-10,38
2804416,16/02/24,Burnley,30,1,4,5,12,13,21,33,-12,27
2804416,16/02/24,Southampton,30,4,1,5,3,22,27,48,-21,18
2804416,16/02/24,Leicester,30,6,5,11,8,11,41,48,-7,41
2804416,16/02/24,Crystal Palace,30,3,3,6,8,16,29,54,-25,26
2804416,16/02/24,Newcastle,30,3,4,7,7,16,22,46,-24,28
2804442,16/02/24,Chelsea,30,9,7,16,8,6,38,29,9,56
2804442,16/02/24,Liverpool,30,7,8,15,4,11,47,38,9,49
2804442,16/02/24,Tottenham,30,7,7,14,4,12,42,40,2,46
2804442,16/02/24,Manchester Blue,30,8,7,15,7,8,60,34,26,52
2804442,16/02/24,Bournemouth,30,8,7,15,5,10,38,26,12,50
2804442,16/02/24,West Ham,30,3,6,9,9,12,32,39,-7,36
2804442,16/02/24,Manchester Reds,30,8,8,16,7,7,45,26,19,55
2804442,16/02/24,Wolverhampton,30,8,6,14,6,10,35,29,6,48
2804442,16/02/24,Watford,30,4,2,6,8,16,28,48,-20,26
2804442,16/02/24,London Guns,30,8,9,17,3,10,48,28,20,54
2804442,16/02/24,Everton,30,6,5,11,5,14,39,44,-5,38
2804442,16/02/24,Burnley,30,1,4,5,10,15,26,38,-12,25
2804442,16/02/24,Southampton,30,5,2,7,5,18,28,52,-24,26
2804442,16/02/24,Leicester,30,9,3,12,7,11,45,48,-3,43
2804442,16/02/24,Crystal Palace,30,5,3,8,6,16,30,58,-28,30
2804442,16/02/24,Newcastle,30,7,3,10,6,14,33,37,-4,36
2804466,16/02/24,Chelsea,30,9,7,16,9,5,51,32,19,57
2804466,16/02/24,Liverpool,30,9,6,15,5,10,45,29,16,50
2804466,16/02/24,Tottenham,30,9,9,18,7,5,57,29,28,61
2804466,16/02/24,Manchester Blue,30,10,9,19,6,5,70,23,47,63
2804466,16/02/24,Bournemouth,30,8,3,11,8,11,30,29,1,41
2804466,16/02/24,West Ham,30,3,6,9,7,14,37,50,-13,34
2804466,16/02/24,Manchester Reds,30,7,6,13,4,13,37,43,-6,43
2804466,16/02/24,Wolverhampton,30,6,4,10,9,11,24,30,-6,39
2804466,16/02/24,Watford,30,7,5,12,6,12,39,37,2,42
2804466,16/02/24,London Guns,30,8,4,12,11,7,34,29,5,47
2804466,16/02/24,Everton,30,8,5,13,10,7,48,37,11,49
2804466,16/02/24,Burnley,30,3,3,6,8,16,16,37,-21,26
2804466,16/02/24,Southampton,30,4,4,8,9,13,31,35,-4,33
2804466,16/02/24,Leicester,30,6,1,7,4,19,25,51,-26,25
2804466,16/02/24,Crystal Palace,30,2,3,5,9,16,17,43,-26,24
2804466,16/02/24,Newcastle,30,2,3,5,10,15,25,52,-27,25
2804492,16/02/24,Chelsea,30,10,7,17,8,5,50,29,21,59
2804492,16/02/24,Liverpool,30,10,7,17,7,6,46,28,18,58
2804492,16/02/24,Tottenham,30,7,0,7,11,12,30,39,-9,32
2804492,16/02/24,Manchester Blue,30,10,7,17,8,5,61,30,31,59
2804492,16/02/24,Bournemouth,30,9,9,18,5,7,54,30,24,59
2804492,16/02/24,West Ham,30,6,5,11,4,15,35,44,-9,37
2804492,16/02/24,Manchester Reds,30,8,7,15,9,6,44,28,16,54
2804492,16/02/24,Wolverhampton,30,9,2,11,6,13,33,35,-2,39
2804492,16/02/24,Watford,30,9,1,10,7,13,29,35,-6,37
2804492,16/02/24,London Guns,30,8,5,13,7,10,47,29,18,46
2804492,16/02/24,Everton,30,9,3,12,4,14,34,39,-5,40
2804492,16/02/24,Burnley,30,5,4,9,7,14,27,41,-14,34
2804492,16/02/24,Southampton,30,3,2,5,6,19,15,53,-38,21
2804492,16/02/24,Leicester,30,6,4,10,6,14,41,43,-2,36
2804492,16/02/24,Crystal Palace,30,6,0,6,9,15,27,45,-18,27
2804492,16/02/24,Newcastle,30,3,3,6,8,16,20,45,-25,26
2804516,16/02/24,Chelsea,30,12,5,17,7,6,55,29,26,58
2804516,16/02/24,Liverpool,30,9,7,16,8,6,44,25,19,56
2804516,16/02/24,Tottenham,30,6,6,12,8,10,43,37,6,44
2804516,16/02/24,Manchester Blue,30,10,10,20,4,6,67,33,34,64
2804516,16/02/24,Bournemouth,30,6,7,13,5,12,39,35,4,44
2804516,16/02/24,West Ham,30,9,2,11,4,15,35,46,-11,37
2804516,16/02/24,Manchester Reds,30,9,4,13,9,8,40,33,7,48
2804516,16/02/24,Wolverhampton,30,8,5,13,10,7,40,28,12,49
2804516,16/02/24,Watford,30,4,4,8,6,16,28,42,-14,30
2804516,16/02/24,London Guns,30,8,6,14,6,10,46,37,9,48
2804516,16/02/24,Everton,30,5,6,11,5,14,40,51,-11,38
2804516,16/02/24,Burnley,30,6,2,8,9,13,28,32,-4,33
2804516,16/02/24,Southampton,30,3,4,7,6,17,27,46,-19,27
2804516,16/02/24,Leicester,30,7,1,8,4,18,38,63,-25,28
2804516,16/02/24,Crystal Palace,30,2,3,5,12,13,32,48,-16,27
2804516,16/02/24,Newcastle,30,5,6,11,3,16,35,52,-17,36
2804548,16/02/24,Chelsea,30,5,4,9,11,10,40,30,10,38
2804548,16/02/24,Liverpool,30,9,6,15,9,6,48,25,23,54
2804548,16/02/24,Tottenham,30,7,9,16,8,6,54,34,20,56
2804548,16/02/24,Manchester Blue,30,13,10,23,2,5,68,28,40,71
2804548,16/02/24,Bournemouth,30,9,7,16,6,8,48,22,26,54
2804548,16/02/24,West Ham,30,6,3,9,10,11,32,43,-11,37
2804548,16/02/24,Manchester Reds,30,8,1,9,9,12,36,43,-7,36
2804548,16/02/24,Wolverhampton,30,7,4,11,11,8,33,31,2,44
2804548,16/02/24,Watford,30,4,5,9,10,11,34,41,-7,37
2804548,16/02/24,London Guns,30,9,5,14,9,7,50,31,19,51
2804548,16/02/24,Everton,30,7,1,8,11,11,35,43,-8,35
2804548,16/02/24,Burnley,30,2,3,5,9,16,20,43,-23,24
2804548,16/02/24,Southampton,30,3,3,6,8,16,24,49,-25,26
2804548,16/02/24,Leicester,30,6,2,8,12,10,39,52,-13,36
2804548,16/02/24,Crystal Palace,30,5,3,8,4,18,33,54,-21,28
2804548,16/02/24,Newcastle,30,3,4,7,5,18,28,53,-25,26
2804572,16/02/24,Chelsea,30,11,6,17,7,6,55,27,28,58
2804572,16/02/24,Liverpool,30,11,6,17,6,7,43,25,18,57
2804572,16/02/24,Tottenham,30,2,4,6,12,12,35,44,-9,30
2804572,16/02/24,Manchester Blue,30,10,8,18,8,4,75,41,34,62
2804572,16/02/24,Bournemouth,30,6,8,14,7,9,41,31,10,49
2804572,16/02/24,West Ham,30,4,2,6,7,17,29,47,-18,25
2804572,16/02/24,Manchester Reds,30,8,8,16,9,5,48,25,23,57
2804572,16/02/24,Wolverhampton,30,9,6,15,8,7,34,22,12,53
2804572,16/02/24,Watford,30,6,3,9,6,15,32,48,-16,33
2804572,16/02/24,London Guns,30,8,8,16,7,7,51,33,18,55
2804572,16/02/24,Everton,30,6,3,9,8,13,41,43,-2,35
2804572,16/02/24,Burnley,30,6,6,12,7,11,31,36,-5,43
2804572,16/02/24,Southampton,30,2,2,4,9,17,16,45,-29,21
2804572,16/02/24,Leicester,30,7,6,13,6,11,49,40,9,45
2804572,16/02/24,Crystal Palace,30,5,3,8,5,17,28,57,-29,29
2804572,16/02/24,Newcastle,30,2,0,2,4,24,22,66,-44,10
2804599,16/02/24,Chelsea,30,8,7,15,9,6,53,31,22,54
2804599,16/02/24,Liverpool,30,11,8,19,5,6,61,35,26,62
2804599,16/02/24,Tottenham,30,13,5,18,7,5,56,25,31,61
2804599,16/02/24,Manchester Blue,30,8,6,14,7,9,44,32,12,49
2804599,16/02/24,Bournemouth,30,7,5,12,9,9,34,36,-2,45
2804599,16/02/24,West Ham,30,5,2,7,8,15,30,45,-15,29
2804599,16/02/24,Manchester Reds,30,7,5,12,7,11,41,41,0,43
2804599,16/02/24,Wolverhampton,30,7,5,12,10,8,34,27,7,46
2804599,16/02/24,Watford,30,8,7,15,5,10,41,42,-1,50
2804599,16/02/24,London Guns,30,8,6,14,7,9,60,36,24,49
2804599,16/02/24,Everton,30,7,4,11,6,13,39,41,-2,39
2804599,16/02/24,Burnley,30,5,3,8,4,18,21,46,-25,28
2804599,16/02/24,Southampton,30,5,2,7,7,16,25,46,-21,28
2804599,16/02/24,Leicester,30,7,4,11,5,14,44,45,-1,38
2804599,16/02/24,Crystal Palace,30,8,2,10,2,18,34,50,-16,32
2804599,16/02/24,Newcastle,30,1,0,1,10,19,18,57,-39,13
2804623,16/02/24,Chelsea,30,9,9,18,5,7,59,30,29,59
2804623,16/02/24,Liverpool,30,8,5,13,7,10,44,31,13,46
2804623,16/02/24,Tottenham,30,8,5,13,9,8,44,33,11,48
2804623,16/02/24,Manchester Blue,30,12,5,17,4,9,53,32,21,55
2804623,16/02/24,Bournemouth,30,5,5,10,12,8,33,29,4,42
2804623,16/02/24,West Ham,30,6,3,9,6,15,26,46,-20,33
2804623,16/02/24,Manchester Reds,30,12,5,17,6,7,48,28,20,57
2804623,16/02/24,Wolverhampton,30,6,5,11,11,8,37,37,0,44
2804623,16/02/24,Watford,30,7,2,9,10,11,32,40,-8,37
2804623,16/02/24,London Guns,30,11,6,17,6,7,54,27,27,57
2804623,16/02/24,Everton,30,7,5,12,9,9,43,35,8,45
2804623,16/02/24,Burnley,30,4,1,5,6,19,19,44,-25,21
2804623,16/02/24,Southampton,30,3,1,4,4,22,14,53,-39,16
2804623,16/02/24,Leicester,30,9,3,12,5,13,44,52,-8,41
2804623,16/02/24,Crystal Palace,30,5,3,8,7,15,24,42,-18,31
2804623,16/02/24,Newcastle,30,5,2,7,9,14,24,39,-15,30
2804650,16/02/24,Chelsea,30,8,6,14,7,9,53,33,20,49
2804650,16/02/24,Liverpool,30,12,8,20,7,3,60,24,36,67
2804650,16/02/24,Tottenham,30,11,7,18,5,7,53,27,26,59
2804650,16/02/24,Manchester Blue,30,12,8,20,6,4,57,27,30,66
2804650,16/02/24,Bournemouth,30,7,4,11,8,11,32,33,-1,41
2804650,16/02/24,West Ham,30,6,0,6,8,16,29,43,-14,26
2804650,16/02/24,Manchester Reds,30,10,6,16,4,10,50,38,12,52
2804650,16/02/24,Wolverhampton,30,6,2,8,10,12,23,31,-8,34
2804650,16/02/24,Watford,30,6,3,9,10,11,29,43,-14,37
2804650,16/02/24,London Guns,30,9,9,18,7,5,64,35,29,61
2804650,16/02/24,Everton,30,4,7,11,8,11,41,47,-6,41
2804650,16/02/24,Burnley,30,3,4,7,7,16,29,43,-14,28
2804650,16/02/24,Southampton,30,2,2,4,9,17,22,44,-22,21
2804650,16/02/24,Leicester,30,4,2,6,9,15,33,59,-26,27
2804650,16/02/24,Crystal Palace,30,4,4,8,8,14,27,43,-16,32
2804650,16/02/24,Newcastle,30,3,2,5,5,20,26,58,-32,20
2804673,16/02/24,Chelsea,30,7,7,14,6,10,37,34,3,48
2804673,16/02/24,Liverpool,30,8,6,14,8,8,40,32,8,50
2804673,16/02/24,Tottenham,30,6,6,12,8,10,46,35,11,44
2804673,16/02/24,Manchester Blue,30,11,10,21,5,4,55,21,34,68
2804673,16/02/24,Bournemouth,30,8,7,15,6,9,40,27,13,51
2804673,16/02/24,West Ham,30,5,1,6,7,17,28,51,-23,25
2804673,16/02/24,Manchester Reds,30,7,5,12,8,10,39,30,9,44
2804673,16/02/24,Wolverhampton,30,5,5,10,14,6,31,27,4,44
2804673,16/02/24,Watford,30,7,5,12,7,11,40,41,-1,43
2804673,16/02/24,London Guns,30,11,4,15,7,8,49,32,17,52
2804673,16/02/24,Everton,30,6,4,10,12,8,42,39,3,42
2804673,16/02/24,Burnley,30,4,1,5,9,16,23,41,-18,24
2804673,16/02/24,Southampton,30,4,2,6,9,15,23,36,-13,27
2804673,16/02/24,Leicester,30,4,2,6,11,13,38,53,-15,29
2804673,16/02/24,Crystal Palace,30,4,3,7,8,15,31,52,-21,29
2804673,16/02/24,Newcastle,30,5,5,10,5,15,29,40,-11,35
2804702,17/02/24,Chelsea,30,11,6,17,6,7,53,28,25,57
2804702,17/02/24,Liverpool,30,8,9,17,8,5,48,24,24,59
2804702,17/02/24,Tottenham,30,6,3,9,8,13,36,42,-6,35
2804702,17/02/24,Manchester Blue,30,13,6,19,3,8,60,31,29,60
2804702,17/02/24,Bournemouth,30,6,6,12,11,7,32,24,8,47
2804702,17/02/24,West Ham,30,8,2,10,9,11,38,41,-3,39
2804702,17/02/24,Manchester Reds,30,12,8,20,3,7,51,28,23,63
2804702,17/02/24,Wolverhampton,30,6,2,8,10,12,26,39,-13,34
2804702,17/02/24,Watford,30,7,4,11,6,13,42,43,-1,39
2804702,17/02/24,London Guns,30,8,5,13,10,7,43,37,6,49
2804702,17/02/24,Everton,30,7,4,11,5,14,39,47,-8,38
2804702,17/02/24,Burnley,30,7,3,10,4,16,33,40,-7,34
2804702,17/02/24,Southampton,30,4,2,6,8,16,27,48,-21,26
2804702,17/02/24,Leicester,30,4,5,9,9,12,36,45,-9,36
2804702,17/02/24,Crystal Palace,30,5,3,8,7,15,38,48,-10,31
2804702,17/02/24,Newcastle,30,3,1,4,5,21,20,57,-37,17
2804727,17/02/24,Chelsea,30,10,9,19,6,5,60,28,32,63
2804727,17/02/24,Liverpool,30,7,6,13,6,11,44,36,8,45
2804727,17/02/24,Tottenham,30,5,7,12,8,10,46,37,9,44
2804727,17/02/24,Manchester Blue,30,9,6,15,5,10,54,35,19,50
2804727,17/02/24,Bournemouth,30,7,5,12,8,10,32,32,0,44
2804727,17/02/24,West Ham,30,4,6,10,9,11,35,54,-19,39
2804727,17/02/24,Manchester Reds,30,8,7,15,8,7,51,25,26,53
2804727,17/02/24,Wolverhampton,30,6,10,16,5,9,42,30,12,53
2804727,17/02/24,Watford,30,3,2,5,6,19,25,49,-24,21
2804727,17/02/24,London Guns,30,8,10,18,7,5,60,32,28,61
2804727,17/02/24,Everton,30,7,7,14,9,7,48,32,16,51
2804727,17/02/24,Burnley,30,1,4,5,6,19,20,56,-36,21
2804727,17/02/24,Southampton,30,4,5,9,7,14,30,45,-15,34
2804727,17/02/24,Leicester,30,5,5,10,7,13,38,41,-3,37
2804727,17/02/24,Crystal Palace,30,4,2,6,8,16,30,52,-22,26
2804727,17/02/24,Newcastle,30,2,5,7,3,20,31,62,-31,24
2804755,17/02/24,Chelsea,30,7,8,15,6,9,42,27,15,51
2804755,17/02/24,Liverpool,30,8,6,14,11,5,43,27,16,53
2804755,17/02/24,Tottenham,30,8,4,12,8,10,52,47,5,44
2804755,17/02/24,Manchester Blue,30,10,5,15,7,8,54,35,19,52
2804755,17/02/24,Bournemouth,30,10,6,16,5,9,33,30,3,53
2804755,17/02/24,West Ham,30,4,2,6,8,16,29,46,-17,26
2804755,17/02/24,Manchester Reds,30,11,6,17,4,9,43,28,15,55
2804755,17/02/24,Wolverhampton,30,7,2,9,7,14,34,43,-9,34
2804755,17/02/24,Watford,30,6,4,10,9,11,33,35,-2,39
2804755,17/02/24,London Guns,30,9,9,18,5,7,57,32,25,59
2804755,17/02/24,Everton,30,7,7,14,6,10,49,44,5,48
2804755,17/02/24,Burnley,30,5,2,7,8,15,25,34,-9,29
2804755,17/02/24,Southampton,30,3,4,7,11,12,27,38,-11,32
2804755,17/02/24,Leicester,30,6,4,10,9,11,43,46,-3,39
2804755,17/02/24,Crystal Palace,30,3,3,6,7,17,28,55,-27,25
2804755,17/02/24,Newcastle,30,3,0,3,11,16,19,44,-25,20
2804778,17/02/24,Chelsea,30,10,5,15,10,5,49,21,28,55
2804778,17/02/24,Liverpool,30,7,9,16,7,7,50,33,17,55
2804778,17/02/24,Tottenham,30,10,5,15,8,7,42,26,16,53
2804778,17/02/24,Manchester Blue,30,8,9,17,7,6,61,31,30,58
2804778,17/02/24,Bournemouth,30,7,8,15,7,8,46,30,16,52
2804778,17/02/24,West Ham,30,3,3,6,9,15,23,50,-27,27
2804778,17/02/24,Manchester Reds,30,7,6,13,8,9,37,35,2,47
2804778,17/02/24,Wolverhampton,30,6,3,9,6,15,35,41,-6,33
2804778,17/02/24,Watford,30,8,4,12,8,10,32,29,3,44
2804778,17/02/24,London Guns,30,11,6,17,8,5,53,37,16,59
2804778,17/02/24,Everton,30,4,2,6,8,16,33,48,-15,26
2804778,17/02/24,Burnley,30,4,2,6,6,18,15,35,-20,24
2804778,17/02/24,Southampton,30,4,4,8,6,16,19,39,-20,30
2804778,17/02/24,Leicester,30,9,4,13,5,12,48,38,10,44
2804778,17/02/24,Crystal Palace,30,4,2,6,8,16,35,56,-21,26
2804778,17/02/24,Newcastle,30,7,2,9,3,18,24,53,-29,30
2804804,17/02/24,Chelsea,30,10,6,16,9,5,48,22,26,57
2804804,17/02/24,Liverpool,30,11,6,17,6,7,44,35,9,57
2804804,17/02/24,Tottenham,30,7,6,13,4,13,39,45,-6,43
2804804,17/02/24,Manchester Blue,30,13,8,21,2,7,64,29,35,65
2804804,17/02/24,Bournemouth,30,6,8,14,8,8,39,30,9,50
2804804,17/02/24,West Ham,30,7,7,14,5,11,42,36,6,47
2804804,17/02/24,Manchester Reds,30,9,6,15,7,8,46,35,11,52
2804804,17/02/24,Wolverhampton,30,5,4,9,12,9,19,21,-2,39
2804804,17/02/24,Watford,30,5,4,9,7,14,35,43,-8,34
2804804,17/02/24,London Guns,30,7,6,13,5,12,45,35,10,44
2804804,17/02/24,Everton,30,8,4,12,5,13,46,45,1,41
2804804,17/02/24,Burnley,30,4,5,9,8,13,26,39,-13,35
2804804,17/02/24,Southampton,30,1,2,3,8,19,19,44,-25,17
2804804,17/02/24,Leicester,30,7,4,11,5,14,42,40,2,38
2804804,17/02/24,Crystal Palace,30,4,4,8,6,16,33,54,-21,30
2804804,17/02/24,Newcastle,30,2,4,6,3,21,20,54,-34,21
2804828,17/02/24,Chelsea,30,12,9,21,5,4,62,23,39,68
2804828,17/02/24,Liverpool,30,8,6,14,12,4,45,27,18,54
2804828,17/02/24,Tottenham,30,10,8,18,5,7,57,32,25,59
2804828,17/02/24,Manchester Blue,30,8,7,15,7,8,53,33,20,52
2804828,17/02/24,Bournemouth,30,8,7,15,6,9,36,24,12,51
2804828,17/02/24,West Ham,30,3,7,10,4,16,28,42,-14,34
2804828,17/02/24,Manchester Reds,30,7,6,13,9,8,45,34,11,48
2804828,17/02/24,Wolverhampton,30,4,4,8,7,15,30,43,-13,31
2804828,17/02/24,Watford,30,7,4,11,6,13,35,38,-3,39
2804828,17/02/24,London Guns,30,7,9,16,7,7,47,39,8,55
2804828,17/02/24,Everton,30,5,6,11,7,12,41,50,-9,40
2804828,17/02/24,Burnley,30,3,3,6,11,13,20,37,-17,29
2804828,17/02/24,Southampton,30,6,2,8,4,18,26,44,-18,28
2804828,17/02/24,Leicester,30,2,4,6,10,14,36,51,-15,28
2804828,17/02/24,Crystal Palace,30,4,2,6,5,19,24,46,-22,23
2804828,17/02/24,Newcastle,30,2,3,5,9,16,23,45,-22,24
2804856,17/02/24,Chelsea,30,10,5,15,3,12,44,35,9,48
2804856,17/02/24,Liverpool,30,10,8,18,8,4,62,21,41,62
2804856,17/02/24,Tottenham,30,11,8,19,6,5,56,25,31,63
2804856,17/02/24,Manchester Blue,30,9,8,17,6,7,57,25,32,57
2804856,17/02/24,Bournemouth,30,8,7,15,8,7,52,27,25,53
2804856,17/02/24,West Ham,30,3,0,3,7,20,26,60,-34,16
2804856,17/02/24,Manchester Reds,30,6,8,14,10,6,41,25,16,52
2804856,17/02/24,Wolverhampton,30,5,6,11,10,9,33,32,1,43
2804856,17/02/24,Watford,30,6,5,11,8,11,42,44,-2,41
2804856,17/02/24,London Guns,30,8,4,12,11,7,43,32,11,47
2804856,17/02/24,Everton,30,8,7,15,5,10,43,49,-6,50
2804856,17/02/24,Burnley,30,5,2,7,10,13,25,43,-18,31
2804856,17/02/24,Southampton,30,3,0,3,8,19,19,51,-32,17
2804856,17/02/24,Leicester,30,6,2,8,8,14,45,55,-10,32
2804856,17/02/24,Crystal Palace,30,4,3,7,5,18,30,66,-36,26
2804856,17/02/24,Newcastle,30,4,2,6,5,19,27,55,-28,23
2804881,17/02/24,Chelsea,30,10,5,15,8,7,44,32,12,53
2804881,17/02/24,Liverpool,30,12,8,20,3,7,56,22,34,63
2804881,17/02/24,Tottenham,30,7,6,13,11,6,48,25,23,50
2804881,17/02/24,Manchester Blue,30,9,8,17,7,6,52,34,18,58
2804881,17/02/24,Bournemouth,30,10,5,15,11,4,45,29,16,56
2804881,17/02/24,West Ham,30,1,2,3,12,15,24,45,-21,21
2804881,17/02/24,Manchester Reds,30,11,6,17,6,7,50,22,28,57
2804881,17/02/24,Wolverhampton,30,6,5,11,10,9,29,27,2,43
2804881,17/02/24,Watford,30,5,2,7,11,12,35,45,-10,32
2804881,17/02/24,London Guns,30,12,5,17,6,7,49,31,18,57
2804881,17/02/24,Everton,30,6,2,8,8,14,33,51,-18,32
2804881,17/02/24,Burnley,30,4,1,5,11,14,27,45,-18,26
2804881,17/02/24,Southampton,30,3,3,6,3,21,24,52,-28,21
2804881,17/02/24,Leicester,30,5,4,9,9,12,40,42,-2,36
2804881,17/02/24,Crystal Palace,30,5,2,7,5,18,25,54,-29,26
2804881,17/02/24,Newcastle,30,3,2,5,9,16,22,47,-25,24
2804907,17/02/24,Chelsea,30,13,10,23,3,4,55,18,37,72
2804907,17/02/24,Liverpool,30,8,4,12,8,10,35,28,7,44
2804907,17/02/24,Tottenham,30,8,5,13,11,6,45,28,17,50
2804907,17/02/24,Manchester Blue,30,7,10,17,10,3,51,24,27,61
2804907,17/02/24,Bournemouth,30,7,6,13,7,10,34,32,2,46
2804907,17/02/24,West Ham,30,4,3,7,8,15,27,45,-18,29
2804907,17/02/24,Manchester Reds,30,8,7,15,7,8,44,35,9,52
2804907,17/02/24,Wolverhampton,30,6,3,9,9,12,22,34,-12,36
2804907,17/02/24,Watford,30,4,6,10,11,9,39,33,6,41
2804907,17/02/24,London Guns,30,5,7,12,11,7,46,28,18,47
2804907,17/02/24,Everton,30,5,5,10,4,16,32,48,-16,34
2804907,17/02/24,Burnley,30,3,3,6,9,15,21,41,-20,27
2804907,17/02/24,Southampton,30,4,3,7,4,19,25,45,-20,25
2804907,17/02/24,Leicester,30,6,4,10,4,16,31,47,-16,34
2804907,17/02/24,Crystal Palace,30,3,1,4,9,17,28,49,-21,21
2804907,17/02/24,Newcastle,30,4,5,9,11,10,42,42,0,38
2804932,17/02/24,Chelsea,30,9,6,15,3,12,47,35,12,48
2804932,17/02/24,Liverpool,30,10,6,16,6,8,56,26,30,54
2804932,17/02/24,Tottenham,30,8,7,15,5,10,42,34,8,50
2804932,17/02/24,Manchester Blue,30,13,6,19,4,7,71,34,37,61
2804932,17/02/24,Bournemouth,30,8,5,13,8,9,31,31,0,47
2804932,17/02/24,West Ham,30,6,4,10,6,14,31,46,-15,36
2804932,17/02/24,Manchester Reds,30,9,3,12,7,11,36,32,4,43
2804932,17/02/24,Wolverhampton,30,6,4,10,9,11,24,27,-3,39
2804932,17/02/24,Watford,30,7,6,13,8,9,38,30,8,47
2804932,17/02/24,London Guns,30,9,8,17,3,10,43,33,10,54
2804932,17/02/24,Everton,30,6,6,12,5,13,36,42,-6,41
2804932,17/02/24,Burnley,30,4,3,7,6,17,21,45,-24,27
2804932,17/02/24,Southampton,30,3,1,4,10,16,20,45,-25,22
2804932,17/02/24,Leicester,30,6,5,11,8,11,40,48,-8,41
2804932,17/02/24,Crystal Palace,30,6,3,9,6,15,38,49,-11,33
2804932,17/02/24,Newcastle,30,6,0,6,8,16,27,44,-17,26
2804959,17/02/24,Chelsea,30,8,6,14,6,10,40,29,11,48
2804959,17/02/24,Liverpool,30,3,7,10,9,11,35,40,-5,39
2804959,17/02/24,Tottenham,30,8,8,16,9,5,49,30,19,57
2804959,17/02/24,Manchester Blue,30,11,5,16,5,9,53,33,20,53
2804959,17/02/24,Bournemouth,30,8,6,14,10,6,44,26,18,52
2804959,17/02/24,West Ham,30,4,2,6,4,20,28,51,-23,22
2804959,17/02/24,Manchester Reds,30,10,8,18,4,8,48,33,15,58
2804959,17/02/24,Wolverhampton,30,4,4,8,7,15,25,34,-9,31
2804959,17/02/24,Watford,30,4,4,8,10,12,38,42,-4,34
2804959,17/02/24,London Guns,30,11,8,19,6,5,62,26,36,63
2804959,17/02/24,Everton,30,7,5,12,10,8,45,42,3,46
2804959,17/02/24,Burnley,30,6,5,11,7,12,26,38,-12,40
2804959,17/02/24,Southampton,30,3,2,5,12,13,24,37,-13,27
2804959,17/02/24,Leicester,30,6,4,10,9,11,37,44,-7,39
2804959,17/02/24,Crystal Palace,30,3,6,9,3,18,24,48,-24,30
2804959,17/02/24,Newcastle,30,3,3,6,5,19,22,47,-25,23
2804983,17/02/24,Chelsea,30,6,6,12,9,9,44,34,10,45
2804983,17/02/24,Liverpool,30,9,9,18,5,7,54,30,24,59
2804983,17/02/24,Tottenham,30,8,5,13,8,9,38,33,5,47
2804983,17/02/24,Manchester Blue,30,9,10,19,5,6,63,28,35,62
2804983,17/02/24,Bournemouth,30,5,3,8,10,12,33,39,-6,34
2804983,17/02/24,West Ham,30,5,3,8,6,16,28,43,-15,30
2804983,17/02/24,Manchester Reds,30,8,4,12,9,9,39,28,11,45
2804983,17/02/24,Wolverhampton,30,6,6,12,7,11,39,35,4,43
2804983,17/02/24,Watford,30,8,5,13,10,7,36,26,10,49
2804983,17/02/24,London Guns,30,8,9,17,8,5,46,25,21,59
2804983,17/02/24,Everton,30,9,5,14,5,11,40,34,6,47
2804983,17/02/24,Burnley,30,4,2,6,6,18,16,43,-27,24
2804983,17/02/24,Southampton,30,3,4,7,4,19,24,48,-24,25
2804983,17/02/24,Leicester,30,7,3,10,5,15,36,56,-20,35
2804983,17/02/24,Crystal Palace,30,7,3,10,4,16,28,45,-17,34
2804983,17/02/24,Newcastle,30,5,3,8,5,17,28,45,-17,29
2805008,17/02/24,Chelsea,30,7,7,14,8,8,46,38,8,50
2805008,17/02/24,Liverpool,30,5,9,14,7,9,47,35,12,49
2805008,17/02/24,Tottenham,30,11,6,17,5,8,54,36,18,56
2805008,17/02/24,Manchester Blue,30,8,8,16,8,6,56,38,18,56
2805008,17/02/24,Bournemouth,30,8,8,16,9,5,39,26,13,57
2805008,17/02/24,West Ham,30,4,5,9,7,14,27,36,-9,34
2805008,17/02/24,Manchester Reds,30,7,5,12,7,11,47,37,10,43
2805008,17/02/24,Wolverhampton,30,3,4,7,8,15,26,41,-15,29
2805008,17/02/24,Watford,30,5,4,9,8,13,31,42,-11,35
2805008,17/02/24,London Guns,30,10,8,18,6,6,61,38,23,60
2805008,17/02/24,Everton,30,7,3,10,7,13,42,44,-2,37
2805008,17/02/24,Burnley,30,5,3,8,7,15,20,32,-12,31
2805008,17/02/24,Southampton,30,3,3,6,10,14,30,46,-16,28
2805008,17/02/24,Leicester,30,5,6,11,3,16,34,43,-9,36
2805008,17/02/24,Crystal Palace,30,3,4,7,14,9,30,35,-5,35
2805008,17/02/24,Newcastle,30,3,1,4,10,16,20,43,-23,22
2805036,18/02/24,Chelsea,30,7,6,13,10,7,45,27,18,49
2805036,18/02/24,Liverpool,30,9,12,21,3,6,58,19,39,66
2805036,18/02/24,Tottenham,30,8,8,16,9,5,47,28,19,57
2805036,18/02/24,Manchester Blue,30,9,6,15,7,8,51,34,17,52
2805036,18/02/24,Bournemouth,30,7,7,14,8,8,42,31,11,50
2805036,18/02/24,West Ham,30,6,2,8,8,14,30,49,-19,32
2805036,18/02/24,Manchester Reds,30,6,9,15,10,5,48,32,16,55
2805036,18/02/24,Wolverhampton,30,5,2,7,7,16,22,40,-18,28
2805036,18/02/24,Watford,30,6,1,7,11,12,39,45,-6,32
2805036,18/02/24,London Guns,30,10,5,15,7,8,50,33,17,52
2805036,18/02/24,Everton,30,5,6,11,7,12,46,45,1,40
2805036,18/02/24,Burnley,30,5,3,8,8,14,29,43,-14,32
2805036,18/02/24,Southampton,30,1,2,3,7,20,23,57,-34,16
2805036,18/02/24,Leicester,30,6,5,11,2,17,47,47,0,35
2805036,18/02/24,Crystal Palace,30,6,3,9,5,16,30,51,-21,32
2805036,18/02/24,Newcastle,30,8,2,10,5,15,21,47,-26,35
2805061,18/02/24,Chelsea,30,6,5,11,9,10,41,41,0,42
2805061,18/02/24,Liverpool,30,8,8,16,12,2,53,19,34,60
2805061,18/02/24,Tottenham,30,5,9,14,8,8,43,32,11,50
2805061,18/02/24,Manchester Blue,30,9,7,16,8,6,50,27,23,56
2805061,18/02/24,Bournemouth,30,5,8,13,9,8,36,28,8,48
2805061,18/02/24,West Ham,30,2,6,8,8,14,27,42,-15,32
2805061,18/02/24,Manchester Reds,30,7,6,13,9,8,43,28,15,48
2805061,18/02/24,Wolverhampton,30,7,5,12,9,9,31,30,1,45
2805061,18/02/24,Watford,30,3,2,5,14,11,30,37,-7,29
2805061,18/02/24,London Guns,30,5,10,15,8,7,48,31,17,53
2805061,18/02/24,Everton,30,4,8,12,5,13,45,38,7,41
2805061,18/02/24,Burnley,30,4,5,9,7,14,26,35,-9,34
2805061,18/02/24,Southampton,30,2,2,4,10,16,12,44,-32,22
2805061,18/02/24,Leicester,30,9,5,14,5,11,42,43,-1,47
2805061,18/02/24,Crystal Palace,30,4,2,6,6,18,36,51,-15,24
2805061,18/02/24,Newcastle,30,4,2,6,5,19,21,58,-37,23
2805085,18/02/24,Chelsea,30,8,5,13,7,10,47,34,13,46
2805085,18/02/24,Liverpool,30,10,8,18,2,10,46,26,20,56
2805085,18/02/24,Tottenham,30,10,5,15,6,9,51,43,8,51
2805085,18/02/24,Manchester Blue,30,9,7,16,8,6,46,29,17,56
2805085,18/02/24,Bournemouth,30,7,7,14,9,7,39,31,8,51
2805085,18/02/24,West Ham,30,8,5,13,3,14,28,40,-12,42
2805085,18/02/24,Manchester Reds,30,8,5,13,12,5,45,29,16,51
2805085,18/02/24,Wolverhampton,30,5,3,8,10,12,27,38,-11,34
2805085,18/02/24,Watford,30,8,3,11,8,11,35,36,-1,41
2805085,18/02/24,London Guns,30,9,8,17,7,6,55,29,26,58
2805085,18/02/24,Everton,30,3,4,7,6,17,34,48,-14,27
2805085,18/02/24,Burnley,30,3,3,6,8,16,23,35,-12,26
2805085,18/02/24,Southampton,30,4,2,6,6,18,26,54,-28,24
2805085,18/02/24,Leicester,30,5,4,9,9,12,41,45,-4,36
2805085,18/02/24,Crystal Palace,30,7,5,12,4,14,34,40,-6,40
2805085,18/02/24,Newcastle,30,3,4,7,5,18,24,44,-20,26
2805111,18/02/24,Chelsea,30,5,8,13,6,11,41,32,9,45
2805111,18/02/24,Liverpool,30,10,7,17,9,4,44,23,21,60
2805111,18/02/24,Tottenham,30,10,5,15,7,8,45,36,9,52
2805111,18/02/24,Manchester Blue,30,7,8,15,7,8,62,39,23,52
2805111,18/02/24,Bournemouth,30,11,5,16,6,8,48,29,19,54
2805111,18/02/24,West Ham,30,7,6,13,8,9,37,37,0,47
2805111,18/02/24,Manchester Reds,30,7,3,10,7,13,34,33,1,37
2805111,18/02/24,Wolverhampton,30,8,3,11,10,9,31,33,-2,43
2805111,18/02/24,Watford,30,8,4,12,5,13,36,35,1,41
2805111,18/02/24,London Guns,30,10,6,16,5,9,57,40,17,53
2805111,18/02/24,Everton,30,9,3,12,6,12,47,38,9,42
2805111,18/02/24,Burnley,30,3,3,6,11,13,26,46,-20,29
2805111,18/02/24,Southampton,30,3,2,5,6,19,26,53,-27,21
2805111,18/02/24,Leicester,30,8,3,11,5,14,40,50,-10,38
2805111,18/02/24,Crystal Palace,30,3,3,6,8,16,25,52,-27,26
2805111,18/02/24,Newcastle,30,6,2,8,2,20,25,48,-23,26
2805137,18/02/24,Chelsea,30,9,5,14,7,9,43,30,13,49
2805137,18/02/24,Liverpool,30,10,7,17,10,3,46,22,24,61
2805137,18/02/24,Tottenham,30,9,8,17,6,7,58,36,22,57
2805137,18/02/24,Manchester Blue,30,12,7,19,4,7,60,34,26,61
2805137,18/02/24,Bournemouth,30,9,7,16,5,9,47,26,21,53
2805137,18/02/24,West Ham,30,6,4,10,9,11,26,33,-7,39
2805137,18/02/24,Manchester Reds,30,7,6,13,6,11,40,32,8,45
2805137,18/02/24,Wolverhampton,30,6,6,12,11,7,33,31,2,47
2805137,18/02/24,Watford,30,7,3,10,4,16,25,39,-14,34
2805137,18/02/24,London Guns,30,7,5,12,8,10,36,32,4,44
2805137,18/02/24,Everton,30,7,2,9,9,12,45,46,-1,36
2805137,18/02/24,Burnley,30,6,0,6,12,12,24,32,-8,30
2805137,18/02/24,Southampton,30,2,2,4,7,19,19,47,-28,19
2805137,18/02/24,Leicester,30,3,5,8,6,16,30,55,-25,30
2805137,18/02/24,Crystal Palace,30,4,1,5,10,15,27,50,-23,25
2805137,18/02/24,Newcastle,30,3,4,7,8,15,31,45,-14,29
2805163,18/02/24,Chelsea,30,9,4,13,9,8,42,27,15,48
2805163,18/02/24,Liverpool,30,6,5,11,12,7,55,35,20,45
2805163,18/02/24,Tottenham,30,9,5,14,8,8,59,43,16,50
2805163,18/02/24,Manchester Blue,30,10,6,16,10,4,61,35,26,58
2805163,18/02/24,Bournemouth,30,9,5,14,10,6,44,32,12,52
2805163,18/02/24,West Ham,30,5,3,8,6,16,34,46,-12,30
2805163,18/02/24,Manchester Reds,30,8,4,12,11,7,47,37,10,47
2805163,18/02/24,Wolverhampton,30,5,4,9,6,15,30,43,-13,33
2805163,18/02/24,Watford,30,6,6,12,9,9,38,34,4,45
2805163,18/02/24,London Guns,30,11,3,14,12,4,47,29,18,54
2805163,18/02/24,Everton,30,6,4,10,8,12,37,41,-4,38
2805163,18/02/24,Burnley,30,5,2,7,8,15,28,46,-18,29
2805163,18/02/24,Southampton,30,4,3,7,9,14,23,38,-15,30
2805163,18/02/24,Leicester,30,4,2,6,12,12,47,59,-12,30
2805163,18/02/24,Crystal Palace,30,4,3,7,6,17,29,54,-25,27
2805163,18/02/24,Newcastle,30,6,2,8,8,14,28,50,-22,32
2805191,18/02/24,Chelsea,30,9,6,15,5,10,52,35,17,50
2805191,18/02/24,Liverpool,30,11,5,16,6,8,45,29,16,54
2805191,18/02/24,Tottenham,30,10,4,14,8,8,48,31,17,50
2805191,18/02/24,Manchester Blue,30,8,7,15,8,7,57,36,21,53
2805191,18/02/24,Bournemouth,30,7,7,14,8,8,38,29,9,50
2805191,18/02/24,West Ham,30,3,1,4,9,17,20,50,-30,21
2805191,18/02/24,Manchester Reds,30,11,4,15,8,7,42,29,13,53
2805191,18/02/24,Wolverhampton,30,10,4,14,6,10,38,31,7,48
2805191,18/02/24,Watford,30,5,2,7,9,14,27,36,-9,30
2805191,18/02/24,London Guns,30,8,8,16,10,4,55,35,20,58
2805191,18/02/24,Everton,30,9,8,17,4,9,47,39,8,55
2805191,18/02/24,Burnley,30,6,3,9,6,15,27,41,-14,33
2805191,18/02/24,Southampton,30,7,2,9,7,14,22,36,-14,34
2805191,18/02/24,Leicester,30,5,3,8,8,14,38,50,-12,32
2805191,18/02/24,Crystal Palace,30,4,0,4,4,22,24,51,-27,16
2805191,18/02/24,Newcastle,30,3,2,5,10,15,31,53,-22,25
2805215,18/02/24,Chelsea,30,12,4,16,11,3,54,25,29,59
2805215,18/02/24,Liverpool,30,11,6,17,7,6,56,32,24,58
2805215,18/02/24,Tottenham,30,9,4,13,7,10,49,41,8,46
2805215,18/02/24,Manchester Blue,30,9,2,11,7,12,47,43,4,40
2805215,18/02/24,Bournemouth,30,5,4,9,13,8,31,30,1,40
2805215,18/02/24,West Ham,30,5,7,12,9,9,34,34,0,45
2805215,18/02/24,Manchester Reds,30,6,7,13,10,7,43,33,10,49
2805215,18/02/24,Wolverhampton,30,5,2,7,10,13,30,44,-14,31
2805215,18/02/24,Watford,30,3,5,8,6,16,33,46,-13,30
2805215,18/02/24,London Guns,30,8,8,16,9,5,58,23,35,57
2805215,18/02/24,Everton,30,8,5,13,9,8,37,34,3,48
2805215,18/02/24,Burnley,30,3,3,6,11,13,31,41,-10,29
2805215,18/02/24,Southampton,30,3,4,7,8,15,32,51,-19,29
2805215,18/02/24,Leicester,30,1,6,7,8,15,38,51,-13,29
2805215,18/02/24,Crystal Palace,30,3,5,8,7,15,35,58,-23,31
2805215,18/02/24,Newcastle,30,2,3,5,12,13,32,54,-22,27
2805242,18/02/24,Chelsea,30,9,7,16,10,4,51,27,24,58
2805242,18/02/24,Liverpool,30,5,6,11,13,6,47,35,12,46
2805242,18/02/24,Tottenham,30,7,6,13,7,10,49,39,10,46
2805242,18/02/24,Manchester Blue,30,9,6,15,8,7,52,32,20,53
2805242,18/02/24,Bournemouth,30,7,6,13,9,8,48,38,10,48
2805242,18/02/24,West Ham,30,3,3,6,7,17,24,50,-26,25
2805242,18/02/24,Manchester Reds,30,13,2,15,6,9,50,39,11,51
2805242,18/02/24,Wolverhampton,30,6,5,11,8,11,35,35,0,41
2805242,18/02/24,Watford,30,7,5,12,6,12,49,44,5,42
2805242,18/02/24,London Guns,30,8,6,14,8,8,38,31,7,50
2805242,18/02/24,Everton,30,5,7,12,6,12,45,44,1,42
2805242,18/02/24,Burnley,30,3,3,6,11,13,17,31,-14,29
2805242,18/02/24,Southampton,30,4,4,8,9,13,27,37,-10,33
2805242,18/02/24,Leicester,30,6,5,11,9,10,47,47,0,42
2805242,18/02/24,Crystal Palace,30,5,4,9,3,18,28,46,-18,30
2805242,18/02/24,Newcastle,30,1,2,3,10,17,24,56,-32,19
2805266,18/02/24,Chelsea,30,9,8,17,10,3,44,24,20,61
2805266,18/02/24,Liverpool,30,9,5,14,6,10,50,35,15,48
2805266,18/02/24,Tottenham,30,4,6,10,8,12,44,52,-8,38
2805266,18/02/24,Manchester Blue,30,10,8,18,4,8,61,35,26,58
2805266,18/02/24,Bournemouth,30,8,7,15,5,10,41,25,16,50
2805266,18/02/24,West Ham,30,4,2,6,7,17,27,46,-19,25
2805266,18/02/24,Manchester Reds,30,9,5,14,9,7,40,27,13,51
2805266,18/02/24,Wolverhampton,30,7,4,11,8,11,43,41,2,41
2805266,18/02/24,Watford,30,3,5,8,12,10,42,45,-3,36
2805266,18/02/24,London Guns,30,11,5,16,6,8,54,35,19,54
2805266,18/02/24,Everton,30,8,1,9,8,13,26,47,-21,35
2805266,18/02/24,Burnley,30,0,3,3,10,17,22,37,-15,19
2805266,18/02/24,Southampton,30,7,2,9,8,13,24,44,-20,35
2805266,18/02/24,Leicester,30,6,5,11,5,14,37,48,-11,38
2805266,18/02/24,Crystal Palace,30,5,4,9,7,14,44,52,-8,34
2805266,18/02/24,Newcastle,30,6,3,9,9,12,30,36,-6,36
2805291,18/02/24,Chelsea,30,11,6,17,7,6,45,22,23,58
2805291,18/02/24,Liverpool,30,7,7,14,8,8,59,33,26,50
2805291,18/02/24,Tottenham,30,7,5,12,8,10,42,40,2,44
2805291,18/02/24,Manchester Blue,30,9,5,14,8,8,44,25,19,50
2805291,18/02/24,Bournemouth,30,6,10,16,5,9,42,30,12,53
2805291,18/02/24,West Ham,30,8,3,11,4,15,32,37,-5,37
2805291,18/02/24,Manchester Reds,30,7,6,13,11,6,53,36,17,50
2805291,18/02/24,Wolverhampton,30,8,3,11,8,11,28,29,-1,41
2805291,18/02/24,Watford,30,8,4,12,5,13,35,36,-1,41
2805291,18/02/24,London Guns,30,8,6,14,11,5,44,27,17,53
2805291,18/02/24,Everton,30,6,5,11,7,12,43,46,-3,40
2805291,18/02/24,Burnley,30,2,0,2,15,13,18,41,-23,21
2805291,18/02/24,Southampton,30,4,1,5,4,21,22,58,-36,19
2805291,18/02/24,Leicester,30,6,2,8,8,14,41,55,-14,32
2805291,18/02/24,Crystal Palace,30,8,5,13,4,13,37,42,-5,43
2805291,18/02/24,Newcastle,30,5,1,6,9,15,28,56,-28,27
2805316,18/02/24,Chelsea,30,8,8,16,9,5,57,28,29,57
2805316,18/02/24,Liverpool,30,12,9,21,5,4,52,17,35,68
2805316,18/02/24,Tottenham,30,9,5,14,7,9,50,37,13,49
2805316,18/02/24,Manchester Blue,30,9,7,16,8,6,58,33,25,56
2805316,18/02/24,Bournemouth,30,7,2,9,8,13,27,37,-10,35
2805316,18/02/24,West Ham,30,4,5,9,2,19,31,51,-20,29
2805316,18/02/24,Manchester Reds,30,11,7,18,4,8,58,36,22,58
2805316,18/02/24,Wolverhampton,30,6,5,11,9,10,35,31,4,42
2805316,18/02/24,Watford,30,9,3,12,3,15,39,41,-2,39
2805316,18/02/24,London Guns,30,5,8,13,9,8,40,37,3,48
2805316,18/02/24,Everton,30,6,3,9,5,16,31,52,-21,32
2805316,18/02/24,Burnley,30,5,3,8,11,11,26,35,-9,35
2805316,18/02/24,Southampton,30,4,3,7,7,16,28,50,-22,28
2805316,18/02/24,Leicester,30,9,3,12,5,13,38,42,-4,41
2805316,18/02/24,Crystal Palace,30,4,3,7,8,15,33,51,-18,29
2805316,18/02/24,Newcastle,30,0,4,4,8,18,27,52,-25,20
